17gsA	
17gsA	mppytvvyfpvrgrcaalrmlladqgqswkeevvtvetwqegslkasclygqlpafqdgdltlyqsntilrhlgrtlglygkdqqeaalvdmvndgvedlrckyisliytnyeagkddyvkalpgqlkpfetllsqnqggktfivgdqisfadynlldlllihevlapgcldafpllsayvgrlsarpklkaflaspeyvnlpingngkq
1a0rP	MEKAKSQSLEEDFEGQASHTGPKGVINDWRKFKLESEDSDSVAHSKKEILRQMSSPQSRDDKDSKERFSRKMSVQEYELIHKDKEDENCLRKYRRQCMQDMHQKLSFGPRYGFVYELESGEQFLETIEKEQKITTIVVHIYEDGIKGCDALNSSLICLAAEYPMVKFCKIKASNTGAGDRFSSDVLPTLLVYKGGELLSNFISVTEQLAEEFFTGDVESFLNEYGLLPEKEMHVLEQTNMEEDME
1a8lA	MGLISDADKKVIKEEFFSKMVNPVKLIVFVRKDHCQYCDQLKQLVQELSELTDKLSYEIVDFDTPEGKELAKRYRIDRAPATTITQDGKDFGVRYFGLPAGHEFAAFLEDIVDVSREETNLMDETKQAIRNIDQDVRILVFVTPTCPYCPLAVRMAHKFAIENTKAGKGKILGDMVEAIEYPEWADQYNVMAVPKIVIQVNGEDRVEFEGAYPEKMFLEKLLSALS
1a8yA	eegldfpeydgvdrvinvnaknyknvfkkyevlallyheppeddkasqrqfemeelilelaaqvledkgvgfglvdsekdaavakklglteedsiyvfkedevieydgefsadtlveflldvledpveliegerelqafeniedeikligyfknkdsehykafkeaaeefhpyipffatfdskvakkltlklneidfyeafmeepvtipdkpnseeeivnfveehrrstlrklkpesmyetweddmdgihivafaeeadpdgyefleilksvaqdntdnpdlsiiwidpddfpllvpywektfdidlsapqigvvnvtdadsvwmemddeedlpsaeeledwledvlegeinteddddedddddddd
1aazA	MFKVYGYDSNIHKCVYCDNAKRLLTVKKQPFEFINIMPEKGVFDDEKIAELLTKLGRDTQIGLTMPQVFAPDGSHIGGFDQLREYFK
1abaA	mfkvygydsnihkcgpcdnakrlltvkkqpfefinimpekgvfddekiaelltklgrdtqigltmpqvfapdgshiggfdqlreyfk
1ac1A	aqyedgkqyttlekpvagapqvleffsffcplcyqfeevlhisdnvkkklpegvkmtkyhvnfmggdlgkdltqawavamalgvedkvtvplfegvqktqtirsasdirdvfinagikgeeydaawnsfvvkslvaqqekaaadvqlrgvpamfvngkyqlnpqgmdtsnmdvfvqqyadtvkylsekk
1acvA	aqyedgkqyttlekpvagapqvleffsffcpscyqfeevlhisdnvkkklpegvkmtkyhvnfmggdlgkdltqawavamalgvedkvtvplfegvqktqtirsasdirdvfinagikgeeydaawnsfvvkslvaqqekaaadvqlrgvpamfvngkyqlnpqgmdtsnmdvfvqqyadtvkylsekk
1agsA	aekpklhyfnargrmestrwllaaagvefeekfiksaedldklrndgylmfqqvpmveidgmklvqtrailnyiaskynlyrkdikekalidmyiegiadlgemilllpftqpeeqdaklalikekiknryfpafekvlkshgqdylvgnklsradihlvellyyveeldsslissfpllkalktrisnlptvkkflqpgsprkppmdeksleearkifrf
1aiuA	mvkqiesktafqealdaagdklvvvdfsatwcgpckmikpffhslsekysnviflevdvndcqdvasecevkcmptfqffkkgqkvgefsgankekleatinelv
1aw9A	aplklygmplspnvvrvatvlnekgldfeivpvdlttgahkqpdflalnpfgqipalvdgdevlfesrainryiaskyasegtdllpatasaaklevwleveshhfypnasplvfqllvrpllggapdaavvdkhaeqlakvldvyeahlarnkylagdeftladanhasyllylsktpkaglvaarphvkawweaivarpafqktvaaiplpppp
1axdA	apmklygavmswnltrcataleeagsdyeivpinfataehkspehlvrnpfgqvpalqdgdlylfesraickyaarknkpellregnleeaamvdvwieveanqytaalnpilfqvlispmlggttdqkvvdenleklkkvlevyearltkckylagdflsladlnhvsvtlclfatpyasvldayphvkawwsglmerpsvqkvaalm
1b48A	aakpklyyfngrgrmesirwllaaagvefeeefletreqyekmqkdghllfgqvplveidgmmltqtrailsylaakynlygkdlkervridmyadgtqdlmmmiavapfktpkekeesydlilsraktryfpvfekilkdhgeaflvgnqlswadiqlleailmveelsapvlsdfpllqafktrisniptikkflqpgsqrkpppdgpyvevvrivlkf
1b4pA	pmilgywnvrglthpirllleytdssyeekryamgdapdydrsqwlnekfklgldfpnlpylidgsrkitqsnaimrylarkhhlcgeteeerirvdvlenqamdtrlqlamvcyspdferkkpeyleglpekmklyseflgkqpwfagnkityvdflvydvldqhrifepkcldafpnlkdfvarfeglkkisdymksgrflskpifakmafwnpk
1b4qA	aqefvnskiqpgkvvvfikptcpysrraqeilsqlpikqgllefvditatnhtneiqdylqqltgartvprvfigkdsiggssdlvslqqsgelltrlkqigalq
1b8xA	spilgywkikglvqptrllleyleekyeehlyerdegdkwrnkkfelglefpnlpyyidgdvkltqsmaiiryiadkhnmlggcpkeraeismlegavldirygvsriayskdfetlkvdflsklpemlkmfedrlchktylngdhvthpdfmlydaldvvlymdpmcldafpklvcfkkrieaipqidkylksskyiawplqgwqatfgggdhppksdlvprgsrrasvgsrmhypgaftysptpvtsgigigmsamgsatryhtylpppypgefivid
1b9xC	meeaasqsleedfegqathtgpkgvindwrkfklesedgdsippskkeilrqmsspqsrddkdskermsrkmeiqeyelihqdkedegclrkyrrqcmqdmhqklsfgprygfvyeletgeqfletiekeqkvttivvniyedgvrgcdalnssleclaaeypmvkfckirasntgagdrfssdvlptllvykggelisnfisvaeqfaedffaadvesflneygllpereihdlgqtntededie
1b9yC	MEEAASQSLEEDFEGQATHTGPKGVINDWRKFKLESEDGDSIPPSKKEILRQMSSPQSRDDKDSKERMSRKMSIQEYELIHQDKEDEGCLRKYRRQCMQDMHQKLSFGPRYGFVYELETGEQFLETIEKEQKVTTIVVNIYEDGVRGCDALNSSLECLAAEYPMVKFCKIRASNTGAGDRFSSDVLPTLLVYKGGELISNFISVAEQFAEDFFAADVESFLNEYGLLPEREIHDLGQTNTEDEDIE
1bedA	aqfkegehyqvlktpassspvvseffsfycphcntfepiiaqlkqqlpegakfqknhvsfmggnmgqamskayatmialevedkmvpvmfnrihtlrkppkdeqelrqifldegidaakfdaayngfavdsmvrrfdkqfqdsgltgvpavvvnnrylvqgqsvksldeyfdlvnylltlk
1bg5A	mspilgywkikglvqptrllleyleekyeehlyerdegdkwrnkkfelglefpnlpyyidgdvkltqsmaiiryiadkhnmlggcpkeraeismlegavldirygvsriayskdfetlkvdflsklpemlkmfedrlchktylngdhvthpdfmlydaldvvlymdpmcldafpklvcfkkrieaipqidkylksskyiawplqgwqatfgggdhppksdlvprgssyyqeaksskimesfknmvpqqalvnss
1bjxA	aattlpdgaaaeslvessevavigffkdvesdsakqflqaaeaiddipfgitsnsdvfskyqldkdgvvlfkkfdegrnnfegevtkenlldfikhnqlplviefteqta
1bq7A	aqyedgkqyttlekpvagapqvleffsffcphcyqfeevlhisdnvkkklpegvkmtkyhvnfmggdlgkdltqawavamalgvedkvtvplfegvqktqtirsasdirdvfinagikgeeydaawnsfvvkslvaqqekaaadvqlrgvaamfvngkyqlnpqgmdtsnmdvfvqqyadtvkylsekk
1byeA	apmklygavmswnltrcataleeagsdyeivpinfataehkspehlvrnpfgqvpalqdgdlylfesraickyaarknkpellregnleeaamvdvwieveanqytaalnpilfqvlispmlggttdqkvvdenleklkkvlevyearltkckylagdflsladlnhvsvtlclfatpyasvldayphvkawwsglmerpsvqkvaalmkpsa
1c72A	vvtlgywdirglahairllleytetpyqerrykagpapdfdpsdwtnekeklgldfpnlpylidgdvkltqsnailryiarkhnmcgetevekqrvdvlenhlmdlrmafarlcyspdfeklkpaylellpgklrqlsrflgsrswfvgdkltfvdflaydvldqqrmfvpdcpelqgnlsqflqrfealekisaymrsgrfmkapifwytalwnnkke
1cqgA	mvkqiesktafqealdaagdklvvvdfsatwcgpakmikpffhslsekysnviflevdvddaqdvaseaevkatptfqffkkgqkvgefsgankekleatinelv
1dbyA	meagavnddtfknvvlessvpvlvdfwapwcgpcriiapvvdeiageykdklkcvklntdespnvaseygirsiptimvfkggkkcetiigavpkativqtvekyln
1dugA	spilgywkikglvqptrllleyleekyeehlyerdegdkwrnkkfelglefpnlpyyidgdvkltqsmaiiryiadkhnmlggcpkeraeismlegavldirygvsriayskdfetlkvdflsklpemlkmfedrlchktylngdhvthpdfmlydaldvvlymdpmcldafpklvcfkkrieaipqidkylksskyiawplqgwqatfgggdhppksdpqqhhlggakqagdv
1e2yA	MSCGAAKLNHPAPEFDDMALMPNGTFKKVSLSSYKGKYVVLFFYPMDFTFVCPTEIIQFSDDAKRFAEINTEVISCSCDSEYSHLQWTSVDRKKGGLGPMAIPMLADKTKAIARAYGVLDEDSGVAYRGVFIIDPNGKLRQIIINDMPIGRNVEEVIRLVEALQFVEEHGEVCPANWKKGDAKKKEGH
1e6bA	MANSGEEKLKLYSYWRSSCAHRVRIALALKGLDYEYIPVNLLKGDQFDSDFKKINPMGTVPALVDGDVVINDSFAIIMYLDEKYPEPPLLPRDLHKRAVNYQAMSIVLSGIQPHQNLAVIRYIEEKINVEEKTAWVNNAITKGFTALEKLLVNCAGKHATGDEIYLADLFLAPQIHGAINRFQINMEPYPTLAKCYESYNELPAFQNALPEKQPDAPSSTI
1eejA	ddaaiqqtlakmgikssdiqpapvagmktvltnsgvlyitddgkhiiqgpmydvsgtapvnvtnkmllkqlnalekemivykapqekhvitvftditcgychklheqmadynalgitvrylafprqgldsdaekemkaiwcakdknkafddvmagksvapascdvdiadhyalgvqlgvsgtpavvlsngtlvpgyqppkemkefldehqkmtsgk
1eemA	MSGESARSLGKGSAPPGPVPEGSIRIYSMRFCPFAERTRLVLKAKGIRHEVININLKNKPEWFFKKNPFGLVPVLENSQGQLIYESAITCEYLDEAYPGKKLLPDDPYEKACQKMILELFSKVPSLVGSFIRSQNKEDYAGLKEEFRKEFTKLEEVLTNKKTTFFGGNSISMIDYLIWPWFERLEAMKLNECVDHTPKLKLWMAAMKEDPTVSALLTSEKDWQGFLELYLQNSPEACDYGL
1egoA	MQTVIFGRSGCPYCVRAKDLAEKLSNERDDFQYQYVDIRAEGITKEDLQQKAGKPVETVPQIFVDQQHIGGYTDFAAWVKENLDA
1eogA	pytvvyfpvrgrcaalrmlladqgqswkeevvtvetwqegslkasclygqlpkfqdgdltlyqsntilrhlgrtlglygkdqqeaalvdmvndgvedlrckyisliytnyeagkddyvkalpgqlkpfetllsqnqggktfivgdqiafadynlldlllihevlapgcldafpllsayvgrlsarpklkaflaspeyvnlpingngkq
1eohA	ppytvvyfpvrgrcaalrmlladqgqswkeevvtvetwqegslkasclygqlpkfqdgdltlyqsntilrhlgrtlglygkdqqeaalvdmvndgvedlrckyisliytnyeagkddyvkalpgqlkpfetllsqnqggktfivgdqisfaaynlldlllihevlapgcldafpllsayvgrlsarpklkaflaspeyvnlpingngkq
1ep7A	ggsvividskaawdaqlakgkeehkpivvdftatwcgpckmiaplfetlsndyagkviflkvdvdavaavaeaagitamptfhvykdgvkaddlvgasqdklkalvakhaaa
1ep8A	ggsvividskaawdaqlakgkeehkpivvaftatwcgpckmiaplfetlsndyagkviflkvdvdavaavaeaagitamptfhvykdgvkaddlvgasqdklkalvakhaaa
1erwA	mvkqiesktafqealdaagdklvvvdfsatwsgpskmikpffhslsekysnviflevdvddcqdvasecevkcmptfqffkkgqkvgefsgankekleatinelv
1ev4A	sgkpvlhyfnargrmecirfllaaagvefdekfiqspedleklkkdgnlmfdqvpmveidgmklaqtrailnyiatkydlygkdmkeralidmysegildltemimqlvicppdqkeaktalakdrtknrylpafekvlkshgqdylvgnkltrvdihllelllyveefdaslltsfpllkafksrisslpnvkkflqpgsqrklpmdakqieearkiykf
1ev9A	sgkpvlhyfnargrmecirfllaaagvefdekfiqspedleklkkdgnlmfdqvpmveidgmklaqtrailnyiatkydlygkdmkeralidmysegildltemimqlvicppdqkeaktalakdrtknrylpafekvlkshgqdylvgnkltrvdihllelllyveefdaslltsfpllkafksrisslpnvkkflqpgsqrklpmdakqieearkifkf
1ewxA	sgldkylpgieklrrgdgevevkslagklvffyfsaswcppcrgftpqliefydkfhesknfevvfctwdeeedgfagyfakmpwlavpfaqseavqklskhfnvesiptligvdadsgdvvttraratlvkdpegeqfpwkdap
1ezkA	sgldkylpgieklrrgdgevevkslagklvffyfsaswcppcrgftpqliefydkfhesknfevvfctwdeeedgfagyfakmpwlavpfaqseavqklskhfnvesiptligvdadsgdvvttraratlvkdpegeqfpwkdaplehhhhhh
1f2eA	MKLFISPGACSLAPHIALRETGADFEAVKVDLAVRKTEAGEDFLTVNPSGKVPALTLDSGETLTENPAILLYIADQNPASGLAPAEGSLDRYRLLSRLSFLGSEFHKAFVPLFAPATSDEAKAAAAESVKNHLAALDKELAGRDHYAGNAFSVADIYLYVMLGWPAYVGIDMAAYPALGAYAGKIAQRPAVGAALKAEGLA
1f3bA	agkpvlhyfnargrmecirwllaaagvefeekfiqspedleklkkdgnlmfdqvpmveidgmklaqtrailnyiatkydlygkdmkeralidmysegildltemigqlvlcppdqreaktalakdrtknrylpafekvlkshgqdylvgnrltrvdihllevllyveefdaslltpfpllkafksrisslpnvkkflqpgsqrkppmdakqiqearkafkiq
1f6mC	sdkiihltddsfdtdvlkadgailvdfwaewcgpskmiapildeiadeyqgkltvaklnidqnpgtapkygirgiptlllfkngevaatkvgalskgqlkefldanla
1f9mA	meaivgkvtevnkdtfwpivkaagdkpvvldmftqwcgpckamapkyeklaeeyldviflkldcnqenktlakelgirvvptfkilkensvvgevtgakydklleaiqaars
1faaA	myylelalgtqemeaivgkvtevnkdtfwpivkaagdkpvvldmftqwcgpckamapkyeklaeeyldviflkldcnqenktlakelgirvvptfkilkensvvgevtgakydklleaiqaars
1fb6A	evqdvndsswkefvlesevpvmvdfwapwcgpckliapvidelakeysgkiavyklntdeapgiatqynirsiptvlffkngerkesiigavpkstltdsiekyl
1fg4A	sglkkffpystnvlkgaaadialpslagktvffyfsaswcppcraftpqlidfykahaekknfevmliswdesaedfkdyyakmpwlalpfedrkgmeflttgfdvksiptlvgveadsgniittqartmvvkdpeakdfpwpnveakk
1fheA	paklgywklrglaqpvrlfleylgeeyeehlygrddrekwmsekfnmgldlpnlpyyiddkckltqsvaimryiadkhgmlgttpeerarismiegaamdlrigfgrvcynpkfeevkeeyvkelpktlkmwsdflgdrhyltgssvshvdfmlyetldsirylaphcldefpklkefksriealpkikaymeskrfikwplngwaasfgagdapps
1fo5A	MSKVKIELFTSPMCPHCPAAKRVVEEVANEMPDAVEVEYINVMENPQKAMEYGIMAVPTIVINGDVEFIGAPTKEALVEAIKKRL
1fohA	tkysesycdvlivgagpaglmaarvlseyvrqkpdlkvriidkrstkvyngqadglqcrtleslknlgladkilseandmstialynpdenghirrtdripdtlpgisryhqvvlhqgrierhildsiaeisdtrikverplipekmeidsskaedpeaypvtmtlrymsdhestplqfghktenslfhsnlqtqeeedanyrlpegkeageietvhckyvigcdgghswvrrtlgfemigeqtdyiwgvldavpasnfpdirsrcaihsaesgsimiiprennlvrfyvqlqaraekggrvdrtkftpevvianakkifhpytfdvqqldwftayhigqrvtekfskdervfiagdachthspkagqgmntsmmdtynlgwklglvltgrakrdilktyeeerhafaqalidfdhqfsrlfsgrpakdvademgvsmdvfkeafvkgnefasgtainydenlvtdkksskqelakncvvgtrfksqpvvrhseglwmhfgdrlvtdgrfriivfagkatdatqmsrikkfsayldsensvislytpkvsdrnsridvitihschrddiemhdfpapalhpkwqydfiyadcdswhhphpksyqawgvdetkgavvvvrpdgytslvtdlegtaeidryfsgilvepkeksgaqteadwtksta
1fovA	anveiytketcpychrakallsskgvsfqelpidgnaakreemikrsgrttvpqifidaqhiggyddlyaldarggldpllk
1fvjA	aqyedgkqyttlekpvagapqvleffsffcpycyqfeevlhisdnvkkklpegvkmtkyhvnfmggdlgkdltqawavamalgvedkvtvplfegvqktqtirsasdirdvfinagikgeeydaawnsfvvkslvaqqekaaadvqlrgvpamfvngkyqlnpqgmdtsnmdvfvqqyadtvkylsekk
1fvkA	aqyedgkqyttlekpvagapqvleffsffcphcyqfeevlhisdnvkkklpegvkmtkyhvnfmggdlgkdltqawavamalgvedkvtvplfegvqktqtirsasdirdvfinagikgeeydaawnsfvvkslvaqqekaaadvqlrgvpamfvngkyqlnpqgmdtsnmdvfvqqyadtvkylsekk
1fw1A	mqagkpilysyfrsscswrvrialalkgidyktvpinlikdggqqfskdfqalnpmkqvptlkidgitihqslaiieyleetrptprllpqdpkkrasvrmisdliaggiqplqnlsvlkqvgeemqltwaqnaitcgfnaleqilqstagiycvgdevtmadlclvpqvanaerfkvdltpyptissinkrllvleafqvshpcrqpdtptelra
1g6wA	mshveysritkffqeqplegytlfshrsapngfkvaivlselgfhyntifldfnlgehrapefvsvnpnarvpalidhgmdnlsiwesgaillhlvnkyyketgnpllwsddladqsqinawlffqtsghapmigqalhfryfhsqkiasaverytdevrrvygvvemalaerrealvmeldtenaaaysagttpmsqsrffdypvwlvgdkltiadlafvpwnnvvdriginikiefpevykwtkhmmrrpavikalrge
1g7eA	lhtkgalpldtvtfykvipkskfvlvkfdtqypygekqdefkrlaensassddllvaevgisdygdklnmelsekykldkesypvfylfrdgdfenpvpysgavkvgaiqrwlkgqgvylgm
1g7oA	MKLYIYDHCPYCLKARMIFGLKNIPVELHVLLNDDAETPTRMVGQKQVPILQKDDSRYMPESMDIVHYVDKLDGKPLLTGKRSPAIEEWLRKVNGYANKLLLPRFAKSAFDEFSTPAARKYFVDKKEASAGNFADLLAHSDGLIKNISDDLRALDKLIVKPNAVNGELSEDDIQLFPLLRNLTLVAGINWPSRVADYRDNMAKQTQINLLSSMAI
1gh2A	vgvkpvgsdpdfqpelsgagsrlavvkftmrgcgpclriapafssmsnkypqavflevdvhqcqgtaatnnisatptfqffrnkvridqyqgadavgleekikqhle
1gl8A	vqdvndsswkefvlesevpvmvdfwapwcgpckliapvidelakeysgkiavyklntdeapgiatqynirsiptvlffkngerkesiigavpkstltdsiekyl
1glqA	ppytivyfpvrgrceamrmlladqgqswkeevvtidtwmqgllkptclygqlpkfedgdltlyqsnailrhlgrslglygknqreaaqmdmvndgvedlrgkyvtliytnyengkndyvkalpghlkpfetllsqnqggkafivgdqisfadynlldlllihqvlapgcldnfpllsayvarlsarpkikaflsspehvnrpingngkq
1gneA	spilgywkikglvqptrllleyleekyeehlyerdegdkwrnkkfelglefpnlpyyidgdvkltqsmaiiryiadkhnmlggcpkeraeismlegavldirygvsriayskdfetlkvdflsklpemlkmfedrlchktylngdhvthpdfmlydaldvvlymdpmcldafpklvcfkkrieaipqidkylksskyiawplqgwqatfgggdhppksdlvprgsmeldkwa
1gnwA	agikvfghpasiatrrvlialheknldfelvhvelkdgehkkepflsrnpfgqvpafedgdlklfesraitqyiahryenqgtnllqtdsknisqyaimaigmqvedhqfdpvasklafeqifksiyglttdeavvaeeeaklakvldvyearlkefkylagetftltdlhhipaiqyllgtptkklfterprvnewvaeitkrpasekvq
1gp1A	aaalaaaaprtvyafsarplaggepfnlsslrgkvllienvaslagttvrdytqmndlqrrlgprglvvlgfpcnqfghqenakneeilnclkyvrpgggfepnfmlfekcevngekahplfaflrevlptpsddatalmtdpkfitwspvcrndvswnfekflvgpdgvpvrrysrrfltidiepdietllsqgasa
1gseA	aekpklhyfnargkmestrwllaaagvefeekfiksaedldklrndgylmfqqvpmveidgmklvqtrailnyiaskynlygkdikeralidmyiegiadlgemilllpvcppeekdaklalikekiknryfpafekvlkshgqdylvgnklsradihlvellyyveeldsslissfpllkalktrisnlptvkkflqpgsprkppmdeksleearkifrf
1gsuA	vvtlgywdirglahairllleytetpyqerrykagpapdfdpsdwtnekeklgldfpnlpylidgdvkltqsnailryiarkhnmcgetevekqrvdvlenhlmdlrmafarlcyspdfeklkpayleqlpgklrqlsrflgsrswfvgdkltfvdflaydvldqqrmfvpdcpelqgnlsqflqrfealekisaymrsgrfmkapifwytalwnnkke
1gtuA	pmilgywdirglahairllleytdssyeekkytmgdapdydrsqwlnekfklgldfpnlpylidgahkitqsnailcyiarkhnlcgeteeekirvdilenqtmdnhmqlgmicynpefeklkpkyleelpeklklyseflgkrpwfagnkitfvdflvydvldlhrifepkcldafpnlkdfisrfeglekisaymkssrflprpvfskmavwgnk
1gukA	maakpklyyfngrgrmesirwllaaagvefeeefletreqyekmqkdghllfgqvplveidgmmltqtrailsylaakynlygkdlkervridmyadgtqdlmmmiavapfktpkekeesydlilsraktryfpvfekilkdhgeaflvgnqlswadiqlleailmveelsapvlsdfpllqafktrisniptikkflqpgsqrkpppdgpyvevvrivlkf
1gulA	MAARPKLHYPNGRGRMESVRWVLAAAGVEFDEEFLETKEQLYKLQDGNHLLFQQVPMVEIDGMKLVQTRSILHYIADKHNLFGKNLKERTLIDMYVEGTLDLLELLIMHPFLKPDDQQKEVVNMAQKAIIRYFPVFEKILRGHGQSFLVGNQLSLADVILLQTILALEEKIPNILSAFPFLQEYTVKLSNIPTIKRFLEPGSKKKPPPDEIYVRTVYNIFRP
1gwcA	MAGGDDLKLLGAWPSPFVTRVKLALALKGLSYEDVEEDLYKKSELLLKSNPVHKKIPVLIHNGAPVCESMIILQYIDEVFASTGPSLLPADPYERAIARFWVAYVDDKLVAPWRQWLRGKTEEEKSEGKKQAFAAVGVLEGALRECSKGGGFFGGDGVGLVDVALGGVLSWMKVTEALSGDKIFDAAKTPLLAAWVERFIELDAAKAALPDVGRLLEFAKAREAAAAASK
1h75A	MRITIYTRNDCVQCHATKRAMENRGFDFEMINVDRVPEAAEALRAQGFRQLPVVIAGDLSWSGFRPDMINRLHPAPHAASA
1hd2A	apikvgdaipavevfegepgnkvnlaelfkgkkgvlfgvpgaftpgcskthlpgfveqaealkakgvqvvaclsvndafvtgewgrahkaegkvrlladptgafgketdlllddslvsifgnrrlkrfsmvvqdgivkalnvepdgtgltcslapniisql
1hnaA	pmtlgywnirglahsirllleytdssyeekkytmgdapdydrsqwlnekfklgldfpnlpylidgthkitqsnailryiarkhnlcgesekeqiredilenqfmdsrmqlaklcydpdfeklkpeylqalpemlklysqflgkqpwflgdkitfvdfiaydvlernqvfepscldafpnlkdfisrfeglekisaymkssrflprpvftkmavfgnk
1hqoA	veysritkffqeqplegytlfshrsapngfkvaivlselgfhyntifldfnlgehrapefvsvnpnarvpalidhgmdnlsiwesgaillhlvnkyyketgnpllwsddladqsqinawlffqtsghapmigqalhfryfhsqkiasaverytdevrrvygvvemalaerrealvmeldtenaaaysagttpmsqsrffdypvwlvgdkltiadlafvpwnnvvdriginikiefpevykwtkhmmrrpavikalrge
1hyuA	MLDTNMKTQLRAYLEKLTKPVELIATLDDSAKSAEIKELLAEIAELSDKVTFKEDNTLPVRKPSFLITNPGSQQGPRFAGSPLGHEFTSLVLALLWTGGHPSKEAQSLLEQIRDIDGDFEFETYYSLSCHNCPDVVQALNLMAVLNPRIKHTAIDGGTFQNEITERNVMGVPAVFVNGKEFGQGRMTLTEIVAKVDTGAEKRAAEALNKRDAYDVLIVGSGPAGAAAAVYSARKGIRTGLMGERFGGQVLDTVDIENYISVPKTEGQKLAGALKAHVSDYDVDVIDSQSASKLVPAATEGGLHQIETASGAVLKARSIIIATGAKWRNMNVPGEDQYRTKGVTYCPHCDGPLFKGKRVAVIGGGNSGVEAAIDLAGIVEHVTLLEFAPEMKADQVLQDKVRSLKNVDIILNAQTTEVKGDGSKVVGLEYRDRVSGDIHSVALAGIFVQIGLLPNTHWLEGALERNRMGEIIIDAKCETSVKGVFAAGDCTTVPYKQIIIATGEGAKASLSAFDYLIRTKIA
1i5gA	sglkkffpystnvlkgaaadialpslagktvffyfsaswcppsraftpqlidfykahaekknfevmliswdesaedfkdyyakmpwlalpfedrkgmeflttgfdvksiptlvgveadsgniittqartmvvkdpeakdfpwpn
1iloA	MMKIQIYGTGCANCQMLEKNAREAVKELGIDAEFEKIKEMDQILEAGLTALPGLAVDGELKIMGRVASKEEIKKILS
1j08A	MGLISEEDKRIIKEEFFSKMVNPVKLIVFIGKEHCQYCDQLKQLVQELSELTDKLSYEIVDFDTPEGKELAEKYRIDRAPATTITQDGKDFGVRYFGIPAGHEFAAFLEDIVDVSKGDTDLMQDSKEEVSKIDKDVRILIFVTPTCPYCPLAVRMAHKFAIENTKAGKGKILGDMVEAIEYPEWADQYNVMAVPKIVIQVNGEDKVQFEGAYPEKMFLEKLLSALS
1j0fA	gsegaatmsglrvystsvtgsreiksqqsevtrildgkriqyqlvdisqdnalrdemrtlagnpkatppqivngnhycgdyelfveaveqdtlqeflkla
1j9bA	MSNITIYHNPACGTSRNTLEMIRNSGTEPTIILYLENPPSRDELVKLIADMGISVRALLRKNVEPYEQLGLAEDKFTDDQLIDFMLQHPILINRPIVVTPLGTRLCRPSEVVLDILQDAQKGAFTKEDGEKVVDEAGKRLK
1jfuA	sraptgdpacraavataqkiaplahgevaaltmasaplklpdlafedadgkpkklsdfrgktllvnlwatwcvpcrkempaldelqgklsgpnfevvainidtrdpekpktflkeanltrlgyfndqkakvfqdlkaigralgmptsvlvdpqgceiatiagpaewasedalkliraatgkaaaal
1jhbA	MAQEFVNCKIQPGKVVVFIKPTCPYCRRAQEILSQLPIKQGLLEFVDITATNHTNEIQDYLQQLTGARTVPRVFIGKDCIGGCSDLVSLQQSGELLTRLKQIGALQ
1jlvA	MDFYYLPGSAPCRAVQMTAAAVGVELNLKLTNLMAGEHMKPEFLKINPQHCIPTLVDNGFALWESRAICTYLAEKYGKDDKLYPKDPQKRAVVNQRLYFDMGTLYQRFADYYYPQIFAKQPANAENEKKMKDAVDFLNTFLDGHKYVAGDSLTIADLTVLATVSTYDVAGFELAKYPHVAAWYERTRKEAPGAAINEAGIEEFRKYFEK
1jlwA	MDFYYLPGSAPCRAVQMTAAAVGVELNLKLTNLMAGEHMKPEFLKLNPQHCIPTLVDEDGFVLWESRAIQIYLVEKYGAHDADLAERLYPSDPRRRAVVHQRLFFDVAVLYQRFAEYYYPQIFGQKVPVGDPGRLRSMEQALEFLNTFLEGEQYVAGGDDPTIADLSILATIATYEVAGYDLRRYENVQRWYERTSAIVPGADKNVEGAKVFGRYFTQK
1jzdA	gamaddaaiqqtlakmgikssdiqpapvagmktvltnsgvlyitddgkhiiqgpmydvsgtapvnvtnkmllkqlnalekemivykapqekhvitvftditcgyshklheqmadynalgitvrylafprqgldsdaekemkaiwcakdknkafddvmagksvapascdvdiadhyalgvqlgvsgtpavvlsngtlvpgyqppkemkefldehqkmtsgk
1jzoA	ddaaiqqtlakmgikssdiqpapvagmktvltnsgvlyitddgkhiiqgpmydvsgtapvnvtnkmllkqlnalekemivykapqekhvitvftditcgyshklheqmadynalgitvrylafprqgldsdaekemkaiwcakdknkafddvmagksvapascdvdiadhyalgvqlgvsgtpavvlsngtlvpgyqppkemkefldehqkmtsgk
1jzwA	msnitiyhnpacgtsrntlemirnsgteptiilylenppsrdelvkliadmgisvrallrknvepyeqlglaedkftddqlidfmlqhpilinrpivvtplgtrlcrpsevvldilqdaqkgaftkedgekvvdeagkrl
1k0dA	shveysritkffqeqplegytlfshrsapngfkvaivlselgfhyntifldfnlgehrapefvsvnpnarvpalidhgmdnlsiwesgaillhlvnkyyketgnpllwsddladqsqinawlffqtsghapmigqalhfryfhsqkiasaverytdevrrvygvvemalaerrealvmeldtenaaaysagttpmsqsrffdypvwlvgdkltiadlafvpwnnvvdriginikiefpevykwtkhmmrrpavikalrge
1k0mA	maeeqpqvelfvkagsdgakigncpfsqrlfmvlwlkgvtfnvttvdtkrrtetvqklcpggelpfllygtevhtdtnkieefleavlcpprypklaalnpesntagldifakfsayiknsnpalndnlekgllkalkvldnyltsplpegvdetsaedegvsqrkfldgneltladcnllpklhivqvvckkyrgftipeafrgvhrylsnayareefastcpddeeielayeqvakalk
1k3yA	aekpklhyfnargrmestrwllaaagvefeekfiksaedldklrndgylmfqqvpmveidgmklvqtrailnyiaskynlygkdikeralidmyiegiadlgemilllpvcppeekdaklalikekiknryfpafekvlkshgqdylvgnklsradihlvellyyveeldsslissfpllkalktrisnlptvkkflqpgsprkppmdeksleearkifrf
1kbnA	ppytvvyfpvrgrcaalrmlladqgqswkeevvtvetwqegslkasclygqlpkfqdgdltlyqsntilrhlgrtlglygkdqqeaalvdmvndgvedlrckyisliytnyeagkddyvkalpgqlkpfetllsqnqggktfivgdqasfadanlldlllihevlapgcldafpllsayvgrlsarpklkaflaspeyvnlpingngkq
1kebA	sdkiihltddsfdtdvlkadgailvdfwaewcgpckliasildeiadeyqgkltvaklnidqnpgtapkygirgiptlllfkngevaatkvgalskgqlkefldanla
1kngA	dpsripsaligrpapqtalppleglqadnvqvpgldpaafkgkvslvnvwaswcvpchdeaplltelgkdkrfqlvginykdaadnarrflgrygnpfgrvgvdangrasiewgvygvpetfvvgregtivyklvgpitpdnlrsvllpqmekalk
1kteA	aqafvnskiqpgkvvvfikptcpfcrktqellsqlpfkegllefvditatsdtneiqdylqqltgartvprvfigkeciggctdlesmhkrgelltrlqqvgavk
1lbkA	ppytvvyfpvrgrcaalrmlladqgqswkeevvtvetwqegslkasclygqlpkfqdgdltlyqsntilrhlgrtlglygkdqqeaalvdmvndgvedlrckyisliytnyeagkddyvkalpgqlkpfetllsqnqggktfivgdqisfadynlldlllihevlapgcldafpllsayvgrlsarpklkaflaspeyvnlpmdeksl
1ljrA	MGLELFLDLVSQPSRAVYIFAKKNGIPLELRTVDLVKGQHKSKEFLQINSLGKLPTLKDGDFILTESSAILIYLSCKYQTPDHWYPSDLQARARVHEYLGWHADCIRGTFGIPLWVQVLGPLIGVQVPEEKVERNRTAMDQALQWLEDKFLGDRPFLAGQQVTLADLMALEELMQPVALGYELFEGRPRLAAWRGRVEAFLGAELCQEAHSIILSILEQAAKKTLPTPSPEAYQAMLLRIARIP
1lu4A	aderlqftattlsgapfdgaslqgkpavlwfwtpwcpfcnaeapslsqvaaanpavtfvgiatradvgamqsfvskynlnftnlndadgviwarynvpwqpafvfyradgtstfvnnptaamsqdelsgrvaalts
1m0uA	MADEAQAPPAEGAPPAEGEAPPPAEGAEGAVEGGEAAPPAEPAEPIKHSYTLFYFNVKALAEPLRYLFAYGNQEYEDVRVTRDEWPALKPTMPMGQMPVLEVDGKRVHQSISMARFLAKTVGLCGATPWEDLQIDIVVDTINDFRLKIAVVSYEPEDEIKEKKLVTLNAEVIPFYLEKLEQTVKDNDGHLALGKLTWADVYFAGITDYMNYMVKRDLLEPYPALRGVVDAVNALEPIKAWIEKRPVTEV
1m2aA	aefkhvfvcvqdrppghpqgscaqrgsrevfqafmekiqtdpqlfmttvitptgcmnacmmgpvvvvypdgvwygqvkpedvdeivekhlkggepverlviskgkppgmf
1m2bA	aefkhvfvcvqdrppghpqgscaqrgsrevfqafmekiqtdpqlfmttvitptgsmnacmmgpvvvvypdgvwygqvkpedvdeivekhlkggepverlviskgkppgmf
1m2dA	aefkhvfvcvqdrppghpqgscaqrgsrevfqafmekiqtdpqlfmttvitptgcmnasmmgpvvvvypdgvwygqvkpedvdeivekhlkggepverlviskgkppgmf
1m7tA	mvkqiesktafqealdaagdklvvvdfsatwcgpckmikpffhslsekysnviflevdvddaqdvapkygirgiptlllfkngevaatkvgalskgqlkefldanlv
1m9aA	MSPILGYWKIKGLVQPTRLLLEYLEEKYEEHLYERDEGDKWRNKKFELGLEFPNLPYYIDGDVKLTQSMAIIRYIADKHNMLGGCPKERAEISMLEGAVLDIRYGVSRIAYSKDFETLKVDFLSKLPEMLKMFEDRLCHKTYLNGDHVTHPDFMLYDALDVVLYMDPMCLDAFPKLVCFKKRIEAIPQIDKYLKSSKYIAWPLQGWQATFGGGDHPPK
1md3A	ppytvvyfpvrgrcaalrmlladqgqswkeevvtvetwqegslkasclygqlpkfqdgdltlyqsntilrhlgrtlglygkdqqeaalvdmvndgvedlrckyisliytnyeagkddyvkalpgqlkpfetllsqnqggktfivadqisfadynlldlllihevlapgcldafpllsayvgrlsarpklkaflaspeyvnlpingngkq
1md4A	ppytvvyfpvrgrcaalrmlladqgqswkeevvtvetwqegslkasclygqlpkfqdgdltlyqsntilrhlgrtlglygkdqqeaalvdmvndgvedlrckyisliytnyeagkddyvkalpgqlkpfetllsqnqggktfivvdqisfadynlldlllihevlapgcldafpllsayvgrlsarpklkaflaspeyvnlpingngkq
1mekA	dapeeedhvlvlrksnfaealaahkyllvefyapwcghckalapeyakaagklkaegseirlakvdateesdlaqqygvrgyptikffrngdtaspkeytagreaddivnwlkkrtgpaa
1ml6A	agkpvlhyfnargrmecirwllaaagvefeekfiqspedleklkkdgnlmfdqvpmveidgmklvqtrailnyiatkydlygkdmkeralidmytegildltemigqlvlcppdqreaktalakdrtknrylpafekvlkshgqdylvgnrltrvdvhllelllyveeldaslltpfpllkafksrisslpnvkkflqpgsqrkppldakqieearkvfkf
1mtcA	pmilgywnvrglthpirllleytdssyeekryamgdapdydrsqwlnekfklgldfpnlpylidgsrkitqsnaimrylarkhhlcgeteeeriradivenqvmdnrmqlimlcfnpdfekqkpeflktipekmklyseflgkrpwfagdkvtyvdflaydildqyhifepkcldafpnlkdflarfeglkkisaymkssrylstpifsklaqwsnk
1n2aA	MKLFYKPGACSLASHITLRESGKDFTLVSVDLMKKRLENGDDYFAVNPKGQVPALLLDDGTLLTEGVAIMQYLADSVPDRQLLAPVNSISRYKTIEWLNYIATELHKGFTPLFRPDTPEEYKPTVRAQLEKKLQYVNEALKDEHWICGQRFTIADAYLFTVLRWAYAVKLNLEGLEHIAAFMQRMAERPEVQDALSAEGLK
1n8jA	slintkikpfknqafkngefievtekdtegrwsvfffypadftfvsptelgdvadhyeelqklgvdvysvstdthfthkawhsssetiakikyamigdptgaltrnfdnmredegladratfvvdpqgiiqaievtaegigrdasdllrkikaaqyvaahpgevcpakwkegeatlapsldlvgki
1nhoA	MVVNIEVFTSPTCPYCPMAIEVVDEAKKEFGDKIDVEKIDIMVDREKAIEYGLMAVPAIAINGVVRFVGAPSREELFEAINDEME
1nhyA	msqgtlyanfrirtwvprglvkalkldvkvvtpdaaaeqfardfplkkvpafvgpkgyklteamainyylvklsqddkmktqllgadddlnaqaqiirwqslansdlciqiantivplkggapynkksvdsamdavdkivdifenrlknytylatenisladlvaasiftryfeslfgtewraqhpaivrwfntvraspflkdeykdfkfadkplsppq
1nm3A	MSSMEGKKVPQVTFRTRQGDKWVDVTTSELFDNKTVIVFSLPGAFTPTCSSSHLPRYNELAPVFKKYGVDDILVVSVNDTFVMNAWKEDEKSENISFIPDGNGEFTEGMGMLVGKEDLGFGKRSWRYSMLVKNGVVEKMFIEPNEPGDPFKVSDADTMLKYLAPQHQVQESISIFTKPGCPFCAKAKQLLHDKGLSFEEIILGHDATIVSVRAVSGRTTVPQVFIGGKHIGGSDDLEKYFA
1nswA	atmtltdanfqqaiqgdgpvlvdfwaawcgpcrmmapvleefaeahadkvtvaklnvdenpettsqfgimsiptlilfkggrpvkqligyqpkeqleaqladvlq
1nw2A	atmtltdanfqqaiqgdkpvlvdfwaawcgpcrmmapvleefaeahadkvtvaklnvdenpettsqfgimsiptlilfkggepvkqligyqpkeqleaqladvlq
1o6jA	msglkkffpystnvlkgaaadialpslagktvffyfsaswcppcraftpqlidfykahaekknfevmliswdesaedfkdyyakmpwlalpfedrkgmeflttgfdvksiptlvgveadsgniittqartmvvkdpeakdfpwpnveakk
1o73A	MSGLAKYLPGATNLLSKSGEVSLGSLVGKTVFLYFSASWCPPCRGFTPVLAEFYEKHHVAKNFEVVLISWDENESDFHDYYGKMPWLALPFDQRSTVSELGKTFGVESIPTLITINADTGAIIGTQARTRVIEDPDGANFPWPN
1o81A	phmsglkkffpystnvlkgaaadialpslagktvffyfsaswcppcraftpqlidfykahaekknfevmliswdesaedfkdyyakmpwlalpfedrkgmeflttgfdvksiptlvgveadsgniittqartmvvkdpeakdfpwpnveakk
1o8xA	msgldkylpgieklrrgdgevevkslagklvffyfsaswcppargftpqliefydkfhesknfevvfctwdeeedgfagyfakmpwlavpfaqseavqklskhfnvesiptligvdadsgdvvttraratlvkdpegeqfpwkdap
1oazA	msdkiihltddsfdtdvlkadgailvdfwaewcgpieesddrrydlvgpckmiapildeiadeyqgkltvaklnidqnpgtapkygirgiptlllfkngevaatkvgalskgqlkefldanla
1oc9A	phmsglkkffpystnvlkgaaadialpslagktvffyfsaswcppcraftpqlidfykahaesknfevmliswdesaedfkdyyakmpwlalpfedrkgmeflttgfdvksiptlvgveadsgniittqartmvvkdpeakdfpwpnveakk
1oe8A	MTGDHIKVIYFNGRGRAESIRMTLVAAGVNYEDERISFQDWPKIKPTIPGGRLPAVKITDNHGHVKWMVESLAIARYMAKKHHMMGGTEEEYYNVEKLIGQAEDLEHEYYKTLMKPEEEKQKIIKEILNGKVPVLLDIICESLKASTGKLAVGDKVTLADLVLIAVIDHVTDLDKEFLTGKYPEIHKHRENLLASSPRLAKYLSDRAATPF
1okdA	msgldkylpgieklrrgdgevevkslagklvffyfsaswcppcrgftpqliefydkfhesknfevvfctwdeeedgfagyfakmpwlavpfaqseavqklskhfnvesiptligvdadsgdvvttraratlvkdpegeqfpwkdaplehhhhhh
1oktA	MGDNIVLYYFDARGKAELIRLIFAYLGIEYTDKRFGVNGDAFVEFKNFKKEKDTPFEQVPILQIGDLILAQSQAIVRYLSKKYNICGESELNEFYADMIFCGVQDIHYKFNNTNLFKQNETTFLNEDLPKWSGYFEKLLKKNHTNNNNDKYYFVGNNLTYADLAVFNLYDDIETKYPSSLKNFPLLKAHNEFISNLPNIKNYITNRKESVY
1on4A	hmleikdplnyevepftfqnqdgknvsleslkgevwladfiftnceticppmtahmtdlqkklkaenidvriisfsvdpendkpkqlkkfaanyplsfdnwdfltgysqseieefalksfkaivkkpegedqvihqssfylvgpdgkvlkdyngventpyddiisdvksastlk
1ovnA	mrgshhhhhhgsvtctgcvdldelsfektverfpysvvkfdiaypygekheaftafsksahkatkdlliatvgvkdygelenkalgdrykvddknfpsiflfkgnadeyvqlpshvdvtldnlkafvsantplyigrdgcikefnevlknyanipdaeqlklieklqakqeqltdpeqqqnarayliymrkihevgydfleeetkrllrlkagkvteakkeellrklnilevfrvhkvtktapekeel
1oyjA	MAEEKELVLLDFWVSPFGQRCRIAMAEKGLEFEYREEDLGNKSDLLLRSNPVHRKIPVLLHAGRPVSESLVILQYLDDAFPGTPHLLPPANSGDADAAYARATARFWADYVDRKLYDCGSRLWRLKGEPQAAAGREMAEILRTLEAELGDREFFGGGGGGRLGFVDVALVPFTAWFYSYERCGGFSVEEVAPRLAAWARRCGRIDSVVKHLPSPEKVYDFVGVLKKKYGVE
1pd21	MPNYKLLYFNMRGRAEIIRYIFAYLDIKYEDHRIEQADWPKIKPTLPFGKIPVLEVEGLTLHQSLAIARYLTKNTDLAGKTELEQCQVDAVVDTLDDFMSLFPWAEENQDLKERTFNDLLTRQAPHLLKDLDTYLGDKEWFIGNYVTWADFYWDICSTTLLVLKPDLLGIYPRLVSLRNKVQAIPAISAWILKRPQTKL
1pgtA	mppytvvyfpvrgrcaalrmlladqgqswkeevvtvetwqegslkasclygqlpkfqdgdltlyqsntilrhlgrtlglygkdqqeaalvdmvndgvedlrckyvsliytnyeagkddyvkalpgqlkpfetllsqnqggktfivgdqisfadynlldlllihevlapgcldafpllsayvgrlsarpklkaflaspeyvnlpingngkq
1pl1A	MAEKPKLHYFNARGRMESTRWLLAAAGVEFEEKFIKSAEDLDKLRNDGYLMFQQVPMVEIDGMKLVQTRAILNYIASKYNLYGKDIKERALIDMYIEGIADLGEMILLLPVCPPEEKDAKLALIKEKIKNRYFPAFEKVLKSHGQDYLVGNKLSRADIHLVELLYYVEELDSSLISSFPLLKALKTRISNLPTVKKFLQPGSPRKPPMDEKSLEEARKIFRF
1pl2A	maekpklhyfnargrmestrwllaaagvefeekfiksaedldklrndgylmfqqvpmveidgmklvqerailnyiaskynlygkdikeralidmyiegiadlgemilllpvcppeekdaklalikekiknryfpafekvlkshgqdylvgnklsradihlvellyyveeldsslissfpllkalktrisnlptvkkflqpgsprkppmdeksleearkifrf
1pmtA	MKLYYTPGSCSLSPHIVLRETGLDFSIERIDLRTKKTESGKDFLAINPKGQVPVLQLDNGDILTEGVAIVQYLADLKPDRNLIAPPKALERYHQIEWLNFLASEVHKGYSPLFSSDTPESYLPVVKNKLKSKFVYINDVLSKQKCVCGDHFTVADAYLFTLSQWAPHVALDLTDLSHLQDYLARIAQRPNVHSALVTEGLIKE
1pn0A	mtkysesycdvlivgagpaglmaarvlseyvrqkpdlkvriidkrstkvyngqadglqcrtleslknlgladkilseandmstialynpdenghirrtdripdtlpgisryhqvvlhqgrierrildsiaeisdtrikverplipekmeidsskaedpeaypvtmtlrymsedestplqfghktenglfrsnlqtqeeedanyrlpegkeageietvhckyvigcdgghswvrrtlgfemigeqtdyiwgvldavpasnfpdirsrcaihsaesgsimiiprennlvrfyvqlqaraekggrvdrtkftpevvianakkifhpytfdvqqldwftayhigqrvtekfskdervfiagdachthspkagqgmntsmmdtynlgwklglvltgrakrdilktyeeerqpfaqalidfdhqfsrlfsgrpakdvademgvsmdvfkeafvkgnefasgtainydenlvtdkksskqelakncvvgtrfksqpvvrhseglwmhfgdrlvtdgrfriivfagkatdatqmsrikkfaayldsensvisrytpkgadrnsridvitihschrddiemhdfpapalhpkwqydfiyadcdswhhphpksyqawgvdetkgavvvvrpdgytslvtdlegtaeidryfsgilvepkeksgaqteadwtksta
1pn9A	MDFYYLPGSAPCRAVQMTAAAVGVELNLKLTDLMKGEHMKPEFLKLNPQHCIPTLVDNGFALWESRAIQIYLAEKYGKDDKLYPKDPQKRAVVNQRLYFDMGTLYQRFADYHYPQIFAKQPANPENEKKMKDAVGFLNTFLEGQEYAAGNDLTIADLSLAATIATYEVAGFDFAPYPNVAAWFARCKANAPGYALNQAGADEFKAKFLS
1pqnA	symlphlhngwqvdqailseedrvvvirfghdwdptcmkmdevlysiaekvknfaviylvditevpdfnkmyelydpctvmfffrnkhimidlgtgnnnkinwamedkqemvdiietvyrgarkgrg
1prxA	mpgglllgdvapnfeanttvgrirfhdflgdswgilfshprdftpvcttelgraaklapefakrnvklialsidsvedhlawskdinaynseepteklpfpiiddrnrelaillgmldpaekdekgmpvtarvvfvfgpdkklklsilypattgrnfdeilrvvislqltaekrvatpvdwkdgdsvmvlptipeeeakklfpkgvftkelpsgkkylrytpqp
1psqA	MVTFLGNPVSFTGKQLQVGDKALDFSLTTTDLSKKSLADFDGKKKVLSVVPSIDTGICSTQTRRFNEELAGLDNTVVLTVSMDLPFAQKRWCGAEGLDNAIMLSDYFDHSFGRDYALLINEWHLLARAVFVLDTDNTIRYVEYVDNINSEPNFEAAIAAAKAL
1px6A	ppytvvyfpvrgrcaalrmlladqgqswkeevvtvetwqegslkasclygqlpkfqdgdltlyqsntilrhlgrtlglygkdqqeaalvdmvndgvedlrckyisliytnyeagkddyvkalpgqlkpfetllsqnqggktfivgdqisfanynlldlllihevlapgcldafpllsayvgrlsarpklkaflaspeyvnlpingngkq
1px7A	ppytvvyfpvrgrcaalrmlladqgqswkeevvtvetwqegslkasclygqlpkfqdgdltlyqsntilrhlgrtlglygkdqqeaalvdmvndgvedlrckyisliytnyeagkddyvkalpgqlkpfetllsqnqggktfivgdqisfaeynlldlllihevlapgcldafpllsayvgrlsarpklkaflaspeyvnlpingngkq
1q98A	MTVTLAGNPIEVGGHFPQVGEIVENFILVGNDLADVALNDFASKRKVLNIFPSIDTGVCATSVRKFNQQAAKLSNTIVLCISADLPFAQARFCGAEGIENAKTVSTFRNHALHSQLGVDIQTGPLAGLTSRAVIVLDEQNNVLHSQLVEEIKEEPNYEAALAVLA
1qfnA	mqtvifgrsgcpysvrakdlaeklsnerddfqyqyvdiraegitkedlqqkagkpvetvpqifvdqqhiggytdfaawvkenlda
1qgvA	MSYMLPHLHNGWQVDQAILSEEDRVVVIRFGHDWDPTCMKMDEVLYSIAEKVKNFAVIYLVDITEVPDFNKMYELYDPCTVMFFFRNKHIMIDLGTGNNNKINWAMEDKQEMVDIIETVYRGARKGRGLVVSPKDYSTKYRY
1qk8A	MSGLDKYLPGIEKLRRGDGEVEVKSLAGKLVFFYFSASWCPPCRGFTPQLIEFYDKFHESKNFEVVFCTWDEEEDGFAGYFAKMPWLAVPFAQSEAVQKLSKHFNVESIPTLIGVDADSGDVVTTRARATLVKDPEGEQFPWKDAP
1qmvA	asgnarigkpapdfkatavvdgafkevklsdykgkyvvlffypldftfvcpteiiafsnraedfrklgcevlgvsvdsqfthlawintprkegglgplniplladvtrrlsedygvlktdegiayrglfiidgkgvlrqitvndlpvgrsvdealrlvqafqytdehgevcpagwkpgsdtikpnvddskeyfskhn
1qq2A	mssgnakighpapsfkatavmpdgqfkdislsdykgkyvvfffypldftfvcpteiiafsdraeefkklncqvigasvdshfshlawintpkkqgglgpmniplvsdpkrtiaqdygvlkadegisfrglfiiddkgilrqitindlpvgrsvdeilrlvqafqftdkhgevcpagwkpgsdtikpdvnkskeyfskqk
1quwA	ATMTLTDANFQQAIQGDKPVLVDFWAAWCGPCRMMAPVLEEFAEAHADKVTVAKLNVDENPETTSQFGIMSIPTLILFKGGRPVKQLIGYQPKEQLEAQLADVLQ
1qxhA	sqtvhfqgnpvtvansipqagskaqtftlvakdlsdvtlgqfagkrkvlnifpsidtgvcaasvrkfnqlateidntvvlcisadlpfaqsrfcgaeglnnvitlstfrnaeflqaygvaiadgplkglaaravvvidendnvifsqlvdeittepdyeaalavlka
1r26A	mrgwhhhhhhgirmrarypsvvdvysveqfrnimsediltvawftavwcgpcktierpmekiayefptvkfakvdadnnseivskcrvlqlptfiiarsgkmlghviganpgmlrqklrdiikdn
1r4wA	MGPAPRVLELFYDVLSPYSWLGFEVLCRYQHLWNIKLKLRPALLAGIMKDSGNQPPAMVPHKGQYILKEIPLLKQLFQVPMSVPKDFFGEHVKKGTVNAMRFLTAVSMEQPEMLEKVSRELWMRIWSRDEDITESQNILSAAEKAGMATAQAQHLLNKISTELVKSKLRETTGAACKYGAFGLPTTVAHVDGKTYMLFGSDRMELLAYLLGEKWMGPVPPTLNARL
1r5aA	MTTVLYYLPASPPCRSVLLLAKMIGVELDLKVLNIMEGEQLKPDFVELNPQHCIPTMDDHGLVLWESRVILSYLVSAYGKDENLYPKDFRSRAIVDQRLHFDLGTLYQRVVDYYFPTIHLGAHLDQTKKAKLAEALGWFEAMLKQYQWSAANHFTIADIALCVTVSQIEAFQFDLHPYPRVRAWLLKCKDELEGHGYKEINETGAETLAGLFRSKLKQ
1r5pA	MNKARKTYVLKLYVAGNTPNSVRALKTLKNILEQEFQGIYALKVIDVLKNPQLAEEDKILATPTLSKILPPPVRKIIGDLSDRERVLIGLDLLYEELTEEDWEAQSNL
1r7hA	MSITLYTKPACVQCTATKKALDRAGLAYNTVDISLDDEARDYVMALGYVQAPVVEVDGEHWSGFRPERIKQLQAA
1rk4A	gsmaeeqpqvelfvkagsdgakigncpfsqrlfmvlwlkgvtfnvttvdtkrrtetvqklcpggqlpfllygtevhtdtnkieefleavlcpprypklaalnpesntagldifakfsayiknsnpalndnlekgllkalkvldnyltsplpeevdetsaedegvsqrkfldgneltladcnllpklhivqvvckkyrgftipeafrgvhrylsnayareefastcpddeeielayeqvakalk
1rqmA	atmtltdanfqqaiqgdgpvlvdfwaawcgpcrmmapvleefaeahadkvtvaklnvdenpettsqfgimsiptlilfkggepvkqligyqpkeqleaqladvlq
1rw1A	tyvlygikacdtmkkartwldehkvaydfhdykavgidrehlrrwcaehgwqtvlnragttfrkldeaqkadldeakaielmlaqpsmikrpvlelggrtlvgfkpdayaaala
1s3aA	kagmaaaaasrgvgaklglreirihlcqrspgsqgvrdfiekryvelkkanpdlpilirecsdvqpklwaryafgqetnvplnnfsadqvtralenvlsgka
1senA	mggshhhhhhgmasssdghnglgkgfgdhihwrtledgkkeaaasglplmviihkswcgackalkpkfaesteiselshnfvmvnledeeepkdedfspdggyiprilfldpsgkvhpeiinengnpsykyfyvsaeqvvqgmkeaqerltgdafrkkhledel
1srxA	sdkiihltddsfdtdlvkadgailvdfwaewcgpckmiapildeiadeyqgkltvaklnidqnpgtapkyiergiptlllfkngevaatkvgalskgqlkefldanla
1st9A	segsdapnfvledtngkrielsdlkgkgvflnfwgtwcepckkefpymanqykhfksqgveivavnvgeskiavhnfmksygvnfpvvldtdrqvldaydvsplpttflinpegkvvkvvtgtmtesmihdymnlikpgetsg
1syrA	mahhhhhhmvkivtsqaefdsiisqnelvivdffaewcgpckriapfyeecsktytkmvfikvdvdevsevtekenitsmptfkvykngssvdtllgandsalkqliekyaa
1t1vA	MSGLRVYSTSVTGSREIKSQQSEVTRILDGKRIQYQLVDISQDNALRDEMRTLAGNPKATPPQIVNGNHYCGDYELFVEAVEQDTLQEFLKLA
1t3bA	ddaaikrklqsfnisniviksspisgiktavtdqgilyvsedgkylfegklyeltnngpvdvagkilvdklnsykdemivypaknekhvvtvfmditchychllhqqlkeyndlgitvrylafpragmnnqtakqmeaiwtakdpvfalneaekgnlpkevktpnivkkhyelgiqfgvrgtpsivtstgeliggylkpadllraleetaq
1t4zA	gsslspqalaqplllqlfvdtrplsqhivqrvknilaaveatvpislqvinvadqpqlveyyrlvvtpalvkigpgsrqvlsgidltdqlanqlpqwlvqqegif
1thoA	sdkiihltddsfdtdvlkadgailvdfwaewcgrpckmiapildeiadeyqgkltvaklnidqnpgtapkygirgiptlllfkngevaatkvgalskgqlkefldanla
1thxA	METAMSKGVITITDAEFESEVLKAEQPVLVYFWASWCGPCQLMSPLINLAANTYSDRLKVVKLEIDPNPTTVKKYKVEGVPALRLVKGEQILDSTEGVISKDKLLSFLDTHLNNN
1ti3A	aeegqviachtvdtwkehfekgkgsqklivvdftaswcppckmiapifaelakkfpnvtflkvdvdelkavaeewnveamptfiflkdgklvdktvgadkdglptlvakhata
1tp9A	MAPIAVGDVLPDGKLAYFDEQDQLQEVSVHSLVAGKKVILFGVPGAFTPTCSLKHVPGFIEKAGELKSKGVTEILCISVNDPFVMKAWAKSYPENKHVKFLADGSATYTHALGLELDLQEKGLGTRSRRFALLVDDLKVKAANIEGGGEFTVSSAEDILKDL
1trvA	mvkqiesktafqealdaagdklvvvdfsatwcgpckmikpffhslsekysnviflevdvddaqdvaseaevkatptfqffkkgqkvgefsgankekleatinelv
1ttzA	maltlyqrddchlcdqavealaqaragaffsvfidddaalesayglrvpvlrdpmgreldwpfdaprlrawldaaphalehhhhhhh
1tu7A	msykltyfsirglaepirlflvdqdikfiddriakddfssiksqfqfgqlpclydgdqqivqsgailrhlarkynlngenemettyidmfcegvrdlhvkytrmiymayetekdpyiksilpgelakfekllatrgngrnlilgdkisyadyalfeeldvhqildphcldkfpllkvfhqrmkdrpklkeycekrdaakvpvngngkq
1tw9A	mvhykltyfngrgagecarqvfaladqkyedvrltqetfvplkatfpfgqvpvlevdgqqlaqsqaicrylaktfgfagatpfesalidsladaytdyraemktyyytalgfmtgdvdkpktdvllpartkflgfitkflkknssgflvgdkiswvdllvaehvadmtnrvpeyiegfpevkahmeriqqtprikkwietrpetpf
1txxA	sdkiihltddsfdtdvlkadgailvdfwaewcvwckmiapildeiadeyqgkltvaklnidqnpgtapkygirgiptlllfkngevaatkvgalskgqlkefldanla
1u3aA	aqyedgkqyttlekpvagapqvleffsffcphayqfeevlhisdnvkkklpegvkmtkyhvnfmggdlgkdltqawavamalgvedkvtvplfegvqktqtirsasdirdvfinagikgeeydaawnsfvvkslvaqqekaaadvqlrgvpamfvngkyqlnpqgmdtsnmdvfvqqyadtvkylsekk
1u87A	mspilgfwkikglvqptrllleyleekyeehlyerdegdkwrnkkfelglefpnlpyyidgdvkltqsmaiiryiadkhnmlggcpkeraeismlegavldirygvsriayskdfetlkvdflsklpemlkmfedrlchktylngdhvthpdfmlydaldvvlymdpmcldafpklvcfkkrieaipqidkylksskyiawplqgwqatfgggdhppk
1uc7A	taqtqthlnftqiktvdelnqalveakgkpvmldlyadwcvackefekytfsdpqvqkaladtvllqanvtandaqdvallkhlnvlglptilffdgqgqehpqarvtgfmdaetfsahlrdrqp
1un2A	qtirsasdirdvfinagikgeeydaawnsfvvkslvaqqekaaadvqlrgvpamfvngkyqlnpqgmdtsnmdvfvqqyadtvkylsekkgggtgaqyedgkqyttlekpvagapqvleffsffcphcyqfeevlhisdnvkkklpegvkmtkyhvnfmggdlgkdltqawavamalgvedkvtvplfegvqktlik
1urmA	rgshhhhhhgsapikvgdaipavevfegepgnkvnlaelfkgkkgvlfgvpgaftpgsskthlpgfveqaealkakgvqvvaclsvndafvtgewgrahkaegkvrlladptgafgketdlllddslvsifgnrrlkrfsmvvqdgivkalnvepdgtgltcslapniisql
1usbA	gstaaekpklhyfnargrmestrwllaaagvefeekfiksaedldklrndgylmfqqvpmveidgmklvqtrailnyiaskynlygkdikeralidmyiegiadlgemilllpvcppeekdaklalikekiknryfpafekvlkshgqdylvgnklsradihlvellyyveeldsslissfpllkalktrisnlptvkkflqpgsprkppmdeksleehrkifrf
1uulA	mscgeaedlhpapdfnetalmpngtfkkvaltsykgkwlvlffypmdftfvcpteicqfsdrvkefsdigcevlacsmdseyshlawtsierkrgglgqmnipiladktkcimksygvlkeedgvayrglfiidpkqnlrqitvndlpvgrdvdealrlvkafqfvekhgevcpanwkpgdktmkpdpekskeyfgavaklp
1v2aA	MDYYYSLISPPCQSAILLAKKLGITLNLKKTNVHDPVERDALTKLNPQHTIPTLVDNGHVVWESYAIVLYLVETYAKDDTLYPKDPKVRSVVNQRLFFDIGTLYKRIIDVIHLVMKKEQPSDEQMEKLKGALDLLEQFVTERAYAAADHLTVADICLLGTVTALNWLKHDLEPFPHIRAWLERVRAEMPDYEEFSKQVADDTLAYVASRK
1v58A	eelpapvkaiekqgitiiktfdapggmkgylgkyqdmgvtiyltpdgkhaisgymynekgenlsntliekeiyapagremwqrmeqshwlldgkkdapvivyvfadpfcpyckqfwqqarpwvdsgkvqlrtllvgvikpespataaailaskdpaktwqqyeasggklklnvpanvsteqmkvlsdneklmddlganvtpaiyymskentlqqavglpdqktlniimgnklqhhhhhhhh
1v9wA	gsegaatmatfeevsvlgfeefdkavkehesktifayfsgskdtegkswcpdcveaepvireglkhvtedcvfiycqvgdkpywkdpnndfrqklkitavptllkygtpqklveseccqsslvemifsed
1vrsD	athtaqtqthlnftqiktvdelnqalveakgkpvmldlyadwcvaskefekytfsdpqvqkaladtvllqanvtandaqdvallkhlnvlglptilffdgqgqehpqarvtgfmdaetfsahlrdrqphhhhhh
1we0A	sligtevqpfraqafqsgkdffevteadlkgkwsivvfypadfsfvcpteledvqkeyaelkklgvevysvstdthfvhkawhenspavgsieyimigdpsqtisrqfdvlneetgladrgtfiidpdgviqaieinadgigrdastlinkvkaaqyvrenpgevcpakweeggetlkpsldivgki
1wikA	gssgssglkvltnkasvmlfmkgnkqeakcgfskqileilnstgveyetfdiledeevrqglktfsnwptypqlyvrgdlvggldivkelkdngellpilkgesgpssg
1wjkA	gssgssgnlsasnralpvltlftkapcplcdeakevlqpykdrfilqevditlpenstwyerykfdipvfhlngqflmmhrvntsklekqlrklsgpssg
1wouA	MARYEEVSVSGFEEFHRAVEQHNGKTIFAYFTGSKDAGGKSWCPDCVQAEPVVREGLKHISEGCVFIYCQVGEKPYWKDPNNDFRKNLKVTAVPTLLKYGTPQKLVESECLQANLVEMLFSED
1wp0A	mgpfsltthtgerktdkdylgqwlliyfgfthcpdvcpeelekmiqvvdeidsittlpdltplfisidperdtkeaianyvkefspklvgltgtreevdqvarayrvyyspgpkdededyivdhtiimyligpdgefldyfgqnkrkgeiaasiathmrpyrkks
1wpiA	MSFWKTLQRQPRTISLFTNDIASNIKSQKCLQLLKGDVSHRFDVEIANRFPTWDQLQYMRTSCPQGPVSLQRQIPKLDSVLKYKHTDPTFGMDLQKCVQRGLWNPKEALWVDWENKLVGNEPADIDKYIIQRK
1xccA	MGYHLGATFPNFTAKASGIDGDFELYKYIENSWAILFSHPNDFTPVCTTELAELGKMHEDFLKLNCKLIGFSCNSKESHDKWIEDIKYYGKLNKWEIPIVCDESRELANKLKIMDEQEKDITGLPLTCRCLFFISPEKKIKATVLYPATTGRNAHEILRVLKSLQLTYTTPVATPVNWNEGDKCCVIPTLQDDEISKHFKNEITKVEMPSKKKYLRFVNL
1xflA	mghhhhhhlemaseegqviachtvetwneqlqkanesktlvvvdftaswcgpcrfiapffadlakklpnvlflkvdtdelksvasdwaiqamptfmflkegkildkvvgakkdelqstiakhla
1xg8A	anlyfqsnavvvygadvicascvnaptskdiydwlqpllkrkypnisfkytyiditkdndnltdhdlqfierieqdelfyplitmndeyvadgyiqtkqitrfidqklvne
1xiyA	mkendlipnvkvmidvrnmnnisdtdgspndftsidthelfnnkkillislpgaftptcstkmipgyeeeydyfikennfddiycitnndiyvlkswfksmdikkikyisdgnssftdsmnmlvdksnffmgmrpwrfvaivennilvkmfqekdkqhniqtdpydistvnnvkeflknnql
1xpvA	MALTLYQRDDCHLCDQAVEALAQARAGAFFSVFIDDDAALESAYGLRVPVLRDPMGRELDWPFDAPRLRAWLDAAPHA
1xvqA	maqitlrgnaintvgelpavgspapaftltggdlgvissdqfrgksvllnifpsvdtpvcatsvrtfderaaasgatvlcvskdlpfaqkrfcgaegtenvmpasafrdsfgedygvtiadgpmagllaraivvigadgnvaytelvpeiaqepnyeaalaalgatsgshhhhhh
1xvwA	kvprgshmlnvgatapdftlrdqnqqlvtlrgyrgaknvllvffplaftgicqgeldqlrdhlpefenddsaalaisvgpppthkiwatqsgftfpllsdfwphgavsqaygvfneqagianrgtfvvdrsgiirfaemkqpgevrdqrlwtdalaalta
1xw5A	pmtlgywnirglahsirllleytdssyeekkytmgdapdydrsqwlnekfklgldfpnlpylidgthkitqsnailryiarkhnlcgesekeqiredilenqfmdsrmqlaklcydpdfeklkpeylqalpemlklysqflgkqpwflgdkitfvdfiaydvlernqvfepscldafpnlkdfisrfeglekisaymkssrflprpvftkmavwgnk
1xw6A	MPMILGYWDIRGLAHAIRLLLEYTDSSYEEKKYTMGDAPDYDRSQWLNEKFKLGLDFPNLPYLIDGAHKITQSNAILCYIARKHNLCGETEEEKIRVDILENQTMDNHMQLGMICYNPEFEKLKPKYLEELPEKLKLYSEFLGKRPWFAGNKITFVDFLVYDVLDLHRIFEPKCLDAFPNLKDFISRFEGLEKISAYMKSSRFLPRPVFSKMAVWGNK
1xwaA	aaaaamvyqvkdkadldgqltkasgklvvldffatwcgpckmispklvelstqfadnvvvlkvdvdecediameynissmptfvflkngvkveefaganakrledvikani
1xwbA	MVYQVKDKADLDGQLTKASGKLVVLDFFATWCGPCKMISPKLVELSTQFADNVVVLKVDVDECEDIAMEYNISSMPTFVFLKNGVKVEEFAGANAKRLEDVIKANI
1xwgA	aekpklhyfnargrmestrwllaaagvefeekfiksaedldklrndgylmfqqvpmveidgmklvqerailnyiaskynlygkdikeralidmyiegiadlgemilllpvcppeekdaklalikekiknryfpafekvlkshgqdylvgnklsradihlvellyyveeldsslissfpllkalktrisnlptvkkflqpgsprkppmdeksleearkifrf
1xxuA	MLNVGATAPDFTLRDQNQQLVTLRGYRGAKNVLLVFFPLAFTGICQGELDQLRDHLPEFENDDSAALAISVGPPPTHKIWATQSGFTFPLLSDFWPHGAVSQAYGVFNEQAGIANRGTFVVDRSGIIRFAEMKQPGEVRDQRLWTDALAALTA
1xzoA	gsqqikdplnyevepftfqnqdgknvsleslkgevwladfiftnceticppmtahmtdlqkklkaenidvriisfsvdpendkpkqlkkfaanyplsfdnwdfltgysqseieefalksfkaivkkpegedqvihqssfylvgpdgkvlkdyngventpyddiisdvksastlk
1y25A	hsqitlrgnaintvgelpavgspapaftltggdlgvissdqfrgksvllnifpsvdtpvsatsvrtfderaaasgatvlcvskdlpfaqkrfcgaegtenvmpasafrdsfgedygvtiadgpmagllaraivvigadgnvaytelvpeiaqepnyeaalaalga
1y6eA	spilgywkikglvqptrllleyleekyeehlyerdegdkwrnkkfelglefpnlpyyidgdvkltqsmaiiryiadkhnmlggcpkeraeismlegavldirygvsriayskdfetlkvdflsklpemlkmfedrlchktylngdhvthpdfmlydaldvvlymdpmcldafpklvcfkkrieaipqidkylksskyiawplqgwqatfgggdhppksdlvpr
1ydkA	maekpklhyfnargrmestrwllaaagvefeekfiksaedldklrndgylmfqqvpmveidgmklvqtrailnyiaskynlygkdikeralidmyiegiadlgemilllpvcppeekdaklalikekiknryfpafekvlkshgqdylvgnklsradihlvellyyveeldsslissfpllkalktrisnlptvkkflqpgsprkppmdeksleearkafrf
1yepA	slintkikpfknqafkngefievtekdtegrwsvfffypadftfvcptelgdvadhyeelqklgvdvysvstdthfthkawhsssetiakikyamigdptgaltrnfdnmredegladratfvvdpqgiiqaievtaegigrdasdllrkikaaqyvaahpgevcpakwkegeatlapsldlvgki
1yexA	slintkikpfknqafkngefievtekdtegrwsvfffypadftfvcptelgdvadhyeelqklgvdvysvstdthfdhkawhsssetiakikyamigdptgaltrnfdnmredegladratfvvdpqgiiqaievtaegigrdasdllrkikaaqyvaahpgevcpakwkegeatlapsldlvgki
1yf0A	slintkikpfknqafkngefievtekdtegrwsvfffypadftfvcptelgdvadhyeelqklgvdvysvstdthfihkawhsssetiakikyamigdptgaltrnfdnmredegladratfvvdpqgiiqaievtaegigrdasdllrkikaaqyvaahpgevcpakwkegeatlapsldlvgki
1yf1A	slintkikpfknqafkngefievtekdtegrwsvfffypadftfvcptelgdvadhyeelqklgvdvysvstdthfvhkawhsssetiakikyamigdptgaltrnfdnmredegladratfvvdpqgiiqaievtaegigrdasdllrkikaaqyvaahpgevcpakwkegeatlapsldlvgki
1z3eA	hmvtlytspsctscrkarawleeheipfvernifseplsideikqilrmtedgtdeiistrskvfqklnvnvesmplqdlyrlinehpgllrrpiiidekrlqvgynedeirrflprkvrsfqlreaqrlan
1z5yE	kpvpkfrlesldnpgqfyqadvltqgkpvllnvwatwcptsraehqylnqlsaqgirvvgmnykddrqkaiswlkelgnpyalslfdgdgmlgldlgvygapetflidgngiiryrhagdlnprvweeeikplwekyskeaaqhhhhhh
1z6mA	snamdisvidatkvntetglhigesnapvkmiefinvrcpycrkwfeeseellaqsvksgkveriiklfdkekeslqrgnvmhhyidysapeqalsalhkmfatqdewgnltleevatyaeknlglkeqkdatlvsaviaeanaahiqfvptiiigeyifdesvteeelrgyiek
1z6nA	MASYAELFDIGEDFAAFVGHGLATEQGAVARFRQKLESNGLPSALTERLQRIERRYRLLVAGEMWCPDCQINLAALDFAQRLQPNIELAIISKGRAEDDLRQRLALERIAIPLVLVLDEEFNLLGRFVERPQAVLDGGPQALAAYKAGDYLEHAIGDVLAIIEGAAR
1z9hA	ersavqlslssrlqltlyqyktcpfcskvrafldfhalpyqvvevnpvlraeikfssyrkvpilvaqegessqqlndssviisalktylvsgqpleeiityypamkavndqgkevtefgnkywlmlnekeaqqvysgkearteemkwrqwaddwlvhlispnvyrtptealasfdyivregkfgavegavakymgaaamyliskrlksrhrlqdnvredlyeaadkwvaavgkdrpfmggqkpnladlavygvlrvmegldafddlmqhthiqpwylrveraiteaspah
1zmaA	snameqfldnikdlevttvvraqealdkketatffigrktcpycrkfagtlsgvvaetkahiyfinseepsqlndlqafrsrygiptvpgfvhitdgqinvrcdssmsaqeikdfagl
1zofA	mvvtklapdfkapavlgnnevdehfelsknlgkngvilffwpkdftfvcpteiiafdkrvkdfhekgfnvigvsidseqvhfawkntpvekggigqvsfpmvaditksisrdydvlfeeaialrgaflidknmkvrhavindlplgrnademlrmvdallhfeehgevcpagwrkgdkgmkathqgvaeylkensikl
1zyeA	mgsshhhhhhssglvprgshmledpapavtqhapyfkgtavvsgefkeislddfkgkylvlffypldftfvcpteiiafsdkasefhdvncevvavsvdshfshlawintprkngglghmniallsdltkqisrdygvllegpglalrglfiidpngvikhlsvndlpvgrsveetlrlvkafqfveahgevspanwtpesptikphptasreyfekvnq
1zypA	mldtnmktqlraylekltkpveliatlddsaksaeikellaeiaelsdkvtfkedntlpvrkpsflitnpgsqqgprfagsplgheftslvlallwtgghpskeaqslleqirdidgdfefetyyslschncpdvvqalnlmavlnprikhtaidggtfqneiternvmgvpavfvngkefgqgrmtlteivakvdtgaekr
1zzoA	tvpaqlqfsaktldghdfhgesllgkpavlwfwapwcptcqgeapvvgqvaashpevtfvgvagldqvpamqefvnkypvktftqladtdgsvwanfgvtqqpayafvdphgnvdvvrgrmsqdeltrrvtaltsr
22gsA	mppytvvyfpvrgrcaalrmlladqgqswkeevvtvetwqegslkasclfgqlpkfqdgdltlyqsntilrhlgrtlglygkdqqeaalvdmvndgvedlrckyisliytnyeagkddyvkalpgqlkpfetllsqnqggktfivgdqisfadynlldlllihevlapgcldafpllsayvgrlsarpklkaflaspeyvnlpingngkq
2a2pA	mtnyrpdwnrlrglargrvetcggcqlnrlkevkafvtediqlyhnlvmkhlpgadpelvllsrnyqeleriplsqmtrdeinalvqelgfyrksapeaqvppeylwapakppeeasehddlehhhhhh
2a2rA	MPPYTVVYFPVRGRCAALRMLLADQGQSWKEEVVTVETWQEGSLKASCLYGQLPKFQDGDLTLYQSNTILRHLGRTLGLYGKDQQEAALVDMVNDGVEDLRCKYISLIYTNYEAGKDDYVKALPGQLKPFETLLSQNQGGKTFIVGDQISFADYNLLDLLLIHEVLAPGCLDAFPLLSAYVGRLSARPKLKAFLASPEYVNLPINGNGKQ
2a4hA	mashhhhhhldqqpaaqrtyakailevctckfraypqiqafiqsgrpakfpnlqikyvrgldpvvklldasgkvqetlsitkwntdtveeffethlakdgagknsysvvedadgdddedylrtnri
2a4vA	ssdvneleigdpipdlsllnedndsislkkitennrvvvffvyprastpgstrqasgfrdnyqelkeyaavfglsadsvtsqkkfqskqnlpyhllsdpkrefigllgakktplsgsirshfifvdgklkfkrvkispevsvndakkevlevaekfkee
2aawA	rgshhhhhhgsmgdnivlyyfdargkaelirlifaylgieytdkrfgvngdafvefknfkkekdtpfeqvpilqigdlilaqsqaivrylskkynicgeselnefyadmifcgvqdihykfnntnlfkqnettflnedlpkwsgyfekllkknhtnnnndkyyfvgnnltyadlavfnlyddietkypsslknfpllkahnefisnlpniknyitnrkesvy
2axoA	missirldlfrtkvfvmplkfplsicllgtflvtsaqaqeavkgvvelftsqgcascppadealrkmiqkgdvvglsyhvdywnylgwtdslaskenterqygymralgrngvytpqailngrdhvkgadvrgiydrldafkregqglnvpvsskfagdeveidigagngkadvvvayftreqtvdvqkgenqgkkmsywhsvydvqtvgmwdgspmtvklpasvvakvkkggcavllqtanasgdpaaivgasillgnetqlehhhhhh
2b3sA	aqyedgkqyttlekpvagapqvleffsffcghayqfeevlhisdnvkkklpegvkmtkyhvnfmggdlgkdltqawavamalgvedkvtvplfegvqktqtirsasdirdvfinagikgeeydaawnsfvvkslvaqqekaaadvqlrgvpamfvngkyqlnpqgmdtsnmdvfvqqyadtvkylsekk
2b5eA	aghmqqeavapedsavvklatdsfneyiqshdlvlaeffapwcghcknmapeyvkaaetlveknitlaqidctenqdlcmehnipgfpslkifknsdvnnsidyegprtaeaivqfmikqsqpavavvadlpaylanetfvtpvivqsgkidadfnatfysmankhfndydfvsaenadddfklsiylpsamdepvvyngkkadiadadvfekwlqvealpyfgeidgsvfaqyvesglplgylfyndeeeleeykplftelakknrglmnfvsidarkfgrhagnlnmkeqfplfaihdmtedlkyglpqlseeafdelsdkivleskaieslvkdflkgdaspivksqeifenqdssvfqlvgknhdeivndpkkdvlvlyyapwcghckrlaptyqeladtyanatsdvliakldhtendvrgvviegyptivlypggkksesvvyqgsrsldslfdfikenghfdvdgkalyeeaqekaaeeadadaeladeedaihdel
2b5xA	MKLRQPMPELTGEKAWLNGEVTREQLIGEKPTLIHFWSISCHLCKEAMPQVNEFRDKYQDQLNVVAVHMPRSEDDLDPGKIKETAAEHDITQPIFVDSDHALTDAFENEYVPAYYVFDKTGQLRHFQAGGSGMKMLEKRVNRVLAETE
2b6mA	aqyedgkqyttlekpvagapqvleffsffcahayqfeevlhisdnvkkklpegvkmtkyhvnfmggdlgkdltqawavamalgvedkvtvplfegvqktqtirsasdirdvfinagikgeeydaawnsfvvkslvaqqekaaadvqlrgvpamfvngkyqlnpqgmdtsnmdvfvqqyadtvkylsekk
2b7kA	rrletqkeaeanrgygkpslggpfhledmygnefteknllgkfsiiyfgfsncpdicpdeldklglwlntlsskygitlqplfitcdpardspavlkeylsdfhpsilgltgtfdevknackkyrvyfstppnvkpgqdylvdhsiffylmdpegqfvdalgrnydektgvdkivehvksyvpaeqrakqkeawysflfk
2bmxA	mplltigdqfpayqltaliggdlskvdakqpgdyfttitsdehpgkwrvvffwpkdftfvcpteiaafsklndefedrdaqilgvsidsefahfqwraqhndlktlpfpmlsdikrelsqaagvlnadgvadrvtfivdpnneiqfvsatagsvgrnvdevlrvldalqsdelcasnwrkgdptldagellkasa
2c0eA	mgsvtctgcvdldelsfektverfpysvvkfdiaypygekheaftafsksahkatkdlliatvgvkdygelenkalgdrykvddknfpsiflfkgnadeyvqlpshvdvtldnlkafvsantplyigrdgcikefnevlknyanipdaeqlklieklqakqeqltdpeqqqnarayliymrkihevgydfleeetkrllrlkagkvteakkeellrklnilevfrvhkvtktapekeelrgshhhhhh
2c0fA	mrgshhhhhhgsvtctgcvdldelsfektverfpysvvkfdiafpygekheaftafsksahkatkdlliatvgvkdygelenkalgdrykvddknfpsiflfkgnadeyvqlpshvdvtldnlkafvsantplyigrdgcikefnevlknyanipdaeqlklieklqakqeqltdpeqqqnarayliymrkihevgydfleeetkrllrlkagkvteakkeellrklnilevfrvhkvtktapekeel
2c0gA	mrgshhhhhhgsvtctgcvdldelsfektverfpysvvkfdiaspygekheaftafsksahkatkdlliatvgvkdygelenkalgdrykvddknfpsiflfkgnadeyvqlpshvdvtldnlkafvsantplyigrdgcikefnevlknyanipdaeqlklieklqakqeqltdpeqqqnarayliymrkihevgydfleeetkrllrlkagkvteakkeellrklnilevfrvhkvtktapekeel
2c1yA	mrgshhhhhhgsvtctgcvdldelsfektverfpysvvkfdiaypkgekheaftafsksahkatkdlliatvgvkdygelenkalgdrykvddknfpsiflfkgnadeyvqlpshvdvtldnlkafvsantplyigrdgcikefnevlknyanipdaeqlklieklqakqeqltdpeqqqnarayliymrkihevgydfleeetkrllrlkagkvteakkeellrklnilevfrvhkvtktapekeel
2c4jA	mpmtlgywnirglahsirllleytdssyeekkytmgdapdydrsqwlnekfklgldfpnlpylidgthkitqsnailryiarkhnlcgesekeqiredilenqfmdsrmqlaklcydpdfeklkpeylqalpemlklysqflgkqpwflgdkitfvdfiaydvlernqvfepscldafpnlkdfisrfeglekisaymkssrflprpvfskmavwgnk
2c8uA	mtgdhikviyfngrgraesiqmtlvaagvnyederisfqdwpkikptipggrlpavkitdnhghvkwmveslaiarymakkhhmmggteeeyynvekligqaedleheyyktlmkpeeekqkiikeilngkvpvlldiiceslkastgklavgdkvtladlvliavidhvtdldkefltgkypeihkhrenllassprlakylsdraatpf
2caqA	mtgdhikviyfngrgraesilmtlvaagvnyederisfqdwpkikptipggrlpavkitdnhghvkwmveslaiarymakkhhmmggteeeyynvekligqaedleheyyktlmkpeeekqkiikeilngkvpvlldiiceslkastgklavgdkvtladlvliavidhvtdldkefltgkypeihkhrenllassprlakylsdraatpf
2cv4A	MPGSIPLIGERFPEMEVTTDHGVIKLPDHYVSQGKWFVLFSHPADFTPVCTTEFVSFARRYEDFQRLGVDLIGLSVDSVFSHIKWKEWIERHIGVRIPFPIIADPQGTVARRLGLLHAESATHTVRGVFIVDARGVIRTMLYYPMELGRLVDEILRIVKALKLGDSLKRAVPADWPNNEIIGEGLIVPPPTTEDQARARMESGQYRCLDWWFCWDTPASRDDVEEARRYLRRAAEKPAKLLYEEARTHLH
2cvbA	MLQYPELPLESPLIDAELPDPRGGRYRLSQFHEPLLAVVFMCNHCPYVKGSIGELVALAERYRGKVAFVGINANDYEKYPEDAPEKMAAFAEEHGIFFPYLLDETQEVAKAYRALRTPEVFLFDERRLLRYHGRVNDNPKDPSKVQSHDLEAAIEALLRGEEPPLKEAPAIGCTIKWRPGNEPEVRIG
2cvdA	pnykltyfnmrgraeiiryifayldiqyedhrieqadwpeikstlpfgkipilevdgltlhqslaiaryltkntdlagntemeqchvdaivdtlddfmscfpwaekkqdvkeqmfnelltynaphlmqdldtylggrewligmsvtwadfyweicsttllvfkpdlldnhprlvtlrkkvqaipavanwikrrpqtkl
2cx4A	mkglvelgekapdftlpnqdfepvnlyevlkrgrpavliffpaafspvctkelctfrdkmaqlekanaevlaisvdspwclkkfkdenrlafnllsdynreviklynvyhedlkglkmvakravfivkpdgtvaykwvtdnplnepdydevvreankiagelva
2djjA	gplgsegpvtvvvaknyneivlddtkdvliefyapwcghckalapkyeelgalyaksefkdrvviakvdatandvpdeiqgfptiklypagakgqpvtysgsrtvedlikfiaengkykaa
2djkA	gplgspligeigpetysdymsagiplayifaetaeerkelsdklkpiaeaqrgvinfgtidakafgahagnlnlktdkfpafaiqevaknqkfpfdqekeitfeaikafvddfvagkiepsiksepipekqeg
2dlxA	gssgssgidkklttladlfrppidlmhkgsfetakecgqmqnkwlminiqnvqdfacqclnrdvwsneavkniirehfifwqvyhdseegqryiqfyklgdfpyvsildprtgqklvewhqldvssfldqvtgflgehgqldglssssgpssg
2es7A	mandtpfsalwqrlltrgwqpveastvddwikrvgdgvillssdprrtpevsdnpvmiaellrefpqfdwqvavadleqseaigdrfnvrrfpatlvftdgklrgalsgihpwaelltlmrsivdtpaaqetvqlehhhhhh
2f8aA	mhhhhhhssgvdlgtenlyfqsmqsvyafsarplaggepvslgslrgkvllienvaslggttvrdytqmnelqrrlgprglvvlgfpcnqfghqenakneeilnslkyvrpgggfepnfmlfekcevngagahplfaflrealpapsddatalmtdpklitwspvcrndvawnfekflvgpdgvplrrysrrfqtidiepdieallsq
2f8fA	mtgdhikviffngrgraesirmtlvaagvnyederisfqdwpkikptipggrlpavkitdnhghvkwmveslaiarymakkhhmmggteeeyynvekligqaedleheyyktlmkpeeekqkiikeilngkvpvlldiiceslkastgklavgdkvtladlvliavidhvtdldkefltgkypeihkhrenllassprlakylsdraatpf
2f9sA	segsdapnfvledtngkrielsdlkgkgvflnfwgtwcepckkefpymanqykhfksqgveivavnvgeskiavhnfmksygvnfpvvldtdrqvldaydvsplpttflinpegkvvkvvtgtmtesmihdymnlikpgetsglehhhhhh
2fa8A	ghmtetkpriairyctqcnwllragwmaqeilqtfasdigevslipstgglfeitvdgtiiwerkrdggfpgpkelkqrirdlidperdlghvdrtkhegldtgs
2fheA	paklgywkirglqqpvrllleylgekyeeqiyerddgekwfskkfelgldlpnlpyyiddkckltqslailryiadkhgmigttseerarvsmiegaavdlrqgisrisyqpkfeqlkegylkdlpttmkmwsdflgknpylrgtsvshvdfmvyealdairylephcldhfpnlqqfmsriealpsikaymesnrfikwplngwhaqfgggdapp
2fnoA	mgsdkihhhhhhmedgmntfdlyywpvpfrgqlirgilahcgcswdehdvdaieglmdcgaekqpvafmgppvlidrernfaisqmpaiaiylgerldilpatvegrtlsakivndandvldeltlnggremwtpekwqefvprlqkwirifadtgarnglsaasgfmlgtekigvadivtailwttvadrfpaikgiiedtspiiwglsrrvvataplaalnsksfeeygnaycggeiekslrkvas
2fug2	MGFFDDKQDFLEETFAKYPPEGRRAAIMPLLRRVQQEEGWIRPERIEEIARLVGTTPTEVMGVASFYSYYQFVPTGKYHLQVCATLSCKLAGAEELWDYLTETLGIGPGEVTPDGLFSVQKVECLGSCHTAPVIQVNDEPYVECVTRARLEALLAGLRAGKRLEEIELPGKCGHHVHEVEV
2fwhA	athtaqtqthlnftqiktvdelnqalveakgkpvmldlyadwcvackefekytfsdpqvqkaladtvllqanvtandaqdvallkhlnvlglptilffdgqgqehpqarvtgfmdaetfsahlrdrqphhhhhh
2fy6A	vphtlstlktadnrpasvylkkdkptlikfwaswcplclselgqtekwaqdakfssanlitvaspgflhekkdgdfqkwyaglnypklpvvtdnggtiaqslnisvypswaligkdgdvqrivkgsineaqalalirdpnadl
2ggtA	llggpfsltthtgerktdkdylgqwlliyfgfthcpdvcpeelekmiqvvdeidsittlpdltplfisidperdtkeaianyvkefspklvgltgtreevdqvarayrvyyspgpkdededyivdhtiimyligpdgefldyfgqnkrkgeiaasiathmrpyr
2gsqA	pkytlhyfplmgraelcrfvlaahgeeftdrvvemadwpnlkatmysnampvldidgtkmsqsmciarhlarefgldgktslekyrvdeitetlqdifndvvkikfapeaakeavqqnyeksckrlapflegllvsngggdgffvgnsmtladlhcyvalevplkhtpellkdcpkivalrkrvaecpkiaaylkkrpvrdf
2gsrA	ppytityfpvrgrceamrmlladqdqswkeevvtmetwpplkpsclfrqlpkfqdgdltlyqsnailrhlgrsfglygkdqkeaalvdmvndgvedlrckyatliytnyeagkekyvkelpehlkpfetllsqnqggqafvvgsqisfadynlldllrihqvlnpscldafpllsayvarlsarpkikaflaspehvnrpingngkq
2gstA	pmilgywnvrglthpirllleytdssyeekryamgdapdydrsqwlnekfklgldfpnlpylidgsrkitqsnaimrylarkhhlcgeteeeriradivenqvmdnrmqlimlcynpdfekqkpeflktipekmklyseflgkrpwfagdkvtyvdflaydildqyhifepkcldafpnlkdflarfeglkkisaymkssrylstpifsklaqwsnk
2h01A	afqgqapsfkaeavfgdntfgevslsdfigkkyvllyfypldftfvcpseiialdkaldsfkernvellgcsvdskfthlawkktplsqggignikhtlisdisksiarsydvlfnesvalrafvlidkqgvvqhllvnnlalgrsvdeilrlidalqhhekygdvcpanwqkgkesmkpseegvakylsnl
2h0gA	eelpapvkaiekqgitiiktfdapggmkgylgkyqdmgvtiyltpdgkhaisgymynekgenlsntliekeiyapagremwqrmeqshwlldgkkdapvivyvfadpfcpyckqfwqqarpwvdsgkvqlrtllvgvikpespataaailaskdpaktwqqyeasggklklnvpanvsteqmkvlsdneklmddlganvmpaiyymskentlqqavglpdqktlniimgnkhhhhhh
2h0hA	eelpapvkaiekqgitiiktfdapggmkgylgkyqdmgvtiyltpdgkhaisgymynekgenlsntliekeiyapagremwqrmeqshwlldgkkdapvivyvfadpfcpyceqfwqqarpwvdsgkvqlrtllvgvikpespataaailaskdpaktwqqyeasggklklnvpanvsteqmkvlsdneklmddlganvtpaiyymskentlqqavglpdqktlniimgnkhhhhhh
2h0iA	eelpapvkaiekqgitiiktfdapggmkgylgkyqdmgvtiyltpdgkhaisgymynekgenlsntliekeiyapagremwqrmeqshwlldgkkdapvivyvfadpfcpyckqfwqqarpwvdsgkvqlrtllvgvikpespataaailaskdpaktwqqyeasggklklnvpanvsteqmkvlsdneklmddlganvtpaiyymskentlqqamglpdqktlniimgnkhhhhhh
2hfdA	msndtpfdalwqrmlargwtpvsesrlddwltqapdgvvllssdpkrtpevsdnpvmigellrefpdytwqvaiadleqseaigdrfgvfrfpatlvftggnyrgvlngihpwaelinlmrglvepqqeraslehhhhhh
2hshA	mvkqiesktafqealdaagdklvvvdfsatwcgpckmikpffhslsekysnviflevdvddcqdvasecevksmptfqffkkgqkvgefsgankekleatinelv
2ifqA	MVKQIESKTAFQEALDAAGDKLVVVDFSATWCGPCKMIKPFFHSLSEKYSNVIFLEVDVDDCQDVASECEVKCMPTFQFFKKGQKVGEFSGANKEKLEATINELV
2jzsA	mvphtlstlktadnrpasvylkkdkptlikfwaswcplclselgqtekwaqdakfssanlitvaspgflhekkdgdfqkwyaglnypklpvvtdnggtiaqslnisvypswaligkdgdvqrivkgsineaqalalirdpnadl
2nvlA	mpgsipligerfpemevttdhgviklpdhyvsqgkwfvlfshpadftpvcttefvsfarryedfqrlgvdliglsvdsvfshikwkewierhigvripfpiiadpqgtvarrlgllhaesathtvrgvfivdargvirtmlyypmelgrlvdeilrivkalklgdslkravpadwpnneiigeglivpppttedqararmesgqyrsldwwfcwdtpasrddveearrylrraaekpakllyeearthlh
2oa7A	ppytivyfpvrgraeamrmlladqgqswkeevvtidtwmqgllkptclygqlpkfedgdltlyqsnailrhlgrslglygknqreaaqmdmvndgvedlrgkyvtliytnyengkndyvkalpghlkpfetllsqnqggkafivgdqisfadynlldlllihqvlapgcldnfpllsayvarlsarpkikaflsspehvnrpingngkq
2oadA	ppytivyfpvrgrceamrmlladqgqswkeevvtidtwmqgllkptclygqlpkfedgdltlyqsnailrhlgrslglygknqreaaqmdmvndgvedlrgkyvtliytnyengkndyvkalpghlkpfetllsqnqggkafivgdqisfadynlldlllihqvlapgaldnfpllsayvarlsarpkikaflsspehvnrpingngkq
2r3xA	maekpklhyfnarglmestrwllaaagvefeekfiksaedldklrndgylmfqqvpmveidgmklvqtrailnyiaskynlygkdikeralidmyiegiadlgemilllpvcppeekdaklalikekiknryfpafekvlkshgqdylvgnklsradihlvellyyveeldsslissfpllkalktrisnlptvkkflqpgsprkppmdeksleearkifrf
2r6kA	maekpklhyfnargrmestrwllaaagvefeekfiksaedldklrndgylmfqqvpmveidgmklvqtravlnyiaskynlygkdikeralidmyiegiadlgemilllpvcppeekdaklalikekiknryfpafekvlkshgqdylvgnklsradihlvellyyveeldsslissfpllkalktrisnlptvkkflqpgsprkppmdeksleearkifrf
2tirA	sdkiihltddsfdtdvlkadgailvdfwaewcgpcemiapildeiadeyqgkltvaklnidqnpgtapkygirgiptlllfkngevaatkvgalskgqlkefldanla
2trcP	egqathtgpkgvindwrkfklesedgdsippskkeilrqmsspqsrddkdskermsrkmsiqeyelihqdkedegclrkyrrqcmqdmhqklsfgprygfvyeletgeqfletiekeqkvttivvniyedgvrgcdalnssleclaaeypmvkfckirasntgagdrfssdvlptllvykggelisnfisvaeqfaedffaadvesflneygllper
2trxA	sdkiihltddsfdtdvlkadgailvdfwaewcgpckmiapildeiadeyqgkltvaklnidqnpgtapkygirgiptlllfkngevaatkvgalskgqlkefldanla
2vcqA	MPNYKLTYFNMRGRAEIIRYIFAYLDIQYEDHRIEQADWPEIKSTLPFGKIPILEVDGLTLHQSLAIARYLTKNTDLAGNTEMEQCHVDAIVDTLDDFMSCFPWAEKKQDVKEQMFNELLTYNAPHLMQDLDTYLGGREWLIGNSVTWADFYWEICSTTLLVFKPDLLDNHPRLVTLRKKVQAIPAVANWIKRRPQTKL
2vl2A	rgshhhhhhgsapikvgdaipavevfegepgnkvnlaelfkgkkgvlfgvpgaftpgcskthlpgfveqaealkakgvqvvaclsvndafvtgewgrahkaegkvrlladptgafgketdlllddslvsifgnrrlkrfsmvvqdgivkalnvepdgtgltcslapniisql
2zctA	pgsipligerfpemevttdhgviklpdhyvsqgkwfvlfshpadftpvcttefvsfarryedfqrlgvdliglsvdsvfshikwkewierhigvripfpiiadpqgtvarrlgllhaesathtvrgvfivdargvirtmlyypmelgrlvdeilrivkalklgdslkravpadwpnneiigeglivpppttedqararmesgqyrsldwwfcwdtpasrddveearrylrraaekpakllyeearthlh
3cshA	ppytvvyfpvrgrcaalrmlladqgqswkeevvtvetwqegslkasclygqlpkfqdgdltlyqsntilrhlgrtlglygkdqqeaalvdmvndgvedlrckyisliytnyeagkddyvkalpgqlkpfetllsqnqggktfivgdqisfadynlldlllihevlapgcldafpllsayvgrlsarpklkaflaspeyvnlpingngkq
3csiA	ppytvvyfpvrgrcaalrmlladqgqswkeevvtvetwqegslkasclygqlpkfqdgdltlyqsntilrhlgrtlglygkdqqeaalvdmvndgvedlrckyvsliytnyevgkddyvkalpgqlkpfetllsqnqggktfivgdqisfadynlldlllihevlapgcldafpllsayvgrlsarpklkaflaspeyvnlpingngkq
3ee2A	MPNYKLTYFNMRGRAEIIRYIFAYLDIQYEDHRIEQADWPEIKSTLPFGKIPILEVDGLTLHQSLAIARYLTKNTDLAGNTEMEQCHVDAIVDTLDDFMSCFPWAEKKQDVKEQMFNELLTYNAPHLMQDLDTYLGGREWLIGNSVTWADFYWEICSTTLLVFKPDLLDNHPRLVTLRKKVQAIPAIANWIKRRPQTKL
3grxA	anveiytketcpyshrakallsskgvsfqelpidgnaakreemikrsgrttvpqifidaqhiggyddlyaldarggldpllk
3gtuB	scessmvlgywdirglahairllleftdtsyeekrytcgeapdydrsqwldvkfkldldfpnlpylldgknkitqsnailryiarkhnmcgeteeekirvdiienqvmdfrtqlirlcyssdheklkpqyleelpgqlkqfsmflgkfswfagekltfvdfltydildqnrifdpkcldefpnlkafmcrfealekiaaylqsdqfckmpinnkmaqwgnkpvc
4gssA	ppytvvyfpvrgrcaalrmlladqgqswkeevvtvetwqegslkasclygqlpkfqdgdltlyqsntilrhlgrtlglygkdqqeaalvdmvndgvedlrckyisliftnyeagkddyvkalpgqlkpfetllsqnqggktfivgdqisfadynlldlllihevlapgcldafpllsayvgrlsarpklkaflaspeyvnlpingngkq
4gtuA	smtlgywdirglahairllleytdssyeekkytmgdapdydrsqwlnekfklgldfpnlpylidgahkitqsnailcyiarkhnlcgeteeekirvdilenqamdvsnqlarvcyspdfeklkpeyleelptmmqhfsqflgkrpwfvgdkitfvdflaydvldlhrifepncldafpnlkdfisrfeglekisaymkssrflpkplytrvavwgnk
4trxA	mvkqiesktafqealdaagdklvvvdfsatwcgpckmikpffhslsekysnviflevdvddcqdvasecevkctptfqffkkgqkvgefsgankekleatinelv
6gsuA	pmilgywnvrglahpirllleytdssyeekryamgdapdydrsqwlnekfklgldfpnlpylidgsrkitqsnaimrylarkhhlcgeteeeriradivenqvmdnrmqlimlcynpdfekqkpeflktipekmklyseflgkrpwfagdkvtyvdflaydildqyhifepkcldafpnlkdflarfeglkkisaymkssrylstpifsklaqwsnk
6gsvA	pmilgywnvrglshpirllleytdssyeekryamgdapdydrsqwlnekfklgldfpnlpylidgsrkitqsnaimrylarkhhlcgeteeeriradivenqvmdnrmqlimlcynpdfekqkpeflktipekmklyseflgkrpwfagdkvtyvdflaydildqyhifepkcldafpnlkdflarfeglkkisaymkssrylstpifsklaqwsnk
6gswA	pmilgywnvrglvhpirllleytdssyeekryamgdapdydrsqwlnekfklgldfpnlpylidgsrkitqsnaimrylarkhhlcgeteeeriradivenqvmdnrmqlimlcynpdfekqkpeflktipekmklyseflgkrpwfagdkvtyvdflaydildqyhifepkcldafpnlkdflarfeglkkisaymkssrylstpifsklaqwsnk
6gsxA	pmilgfwnvrglthpirllleytdssyeekryamgdapdydrsqwlnekfklgldfpnlpylidgsrkitqsnaimrylarkhhlcgeteeeriradivenqvmdnrmqlimlcynpdfekqkpeflktipekmklyseflgkrpwfagdkvtyvdflaydildqyhifepkcldafpnlkdflarfeglkkisaymkssrylstpifsklaqwsnk
